|-----oE--------|----EX--Bo--oo----------oo---X----o----T--o--------------o|--X----------Eo--B-o--o--|-XB-----ET------XooEX----Eo-----B---------o--X-------o-X--o-o---B---oT---------oo--oX---oX-------|
|--M----|oXM---o-B?oXX-Xo-o--------o----o----EB---XM-X-oX------B--o-B-----------Bo----o-MX-o--M---|oX-------o-MX--o-----M-----oB-MX---oE--o------?---o-------XXo------E-o---M---?EM-BX-B--XX--|------M-T
o---o-------o-?--BXM---Bo----M--E---------o-----T-o--B---o----Mo---?-------o---Xo-------|--X------X--------o-oo|--------o--B---B-XX-----M-ooB----o-----o?----BXME-------o-E-oo---X-?-----X--oMX----Bo-oX
M-?-----------oo-Boo--o---o--oo---o--o-o-o-X------B--X---M--oB|--X-E------o-o--oE------X---Bo-----E-------o--?---o--?------o-B-E?o--o---E----o-?---|------E--o------o---Eo--o-EooE-X---------o----Bo----
E--??M-T----------ET---B------ME--o--oM--o---M?----M--M---B--|----EB--Eo----T--M?--oo--o--------o---M---M-Eo-E?-o-E--X-BooM--------o--BoBE--o--X---|------?--o------M---------?-M-XoMo-oM------X-B-----|
----XB-X------X--EX|-?-X-----oB?o-X--oo--o--Eo-----o--X-----oX----B---XE-?------Xo-o-X--------Xo-T--X--oB----B-X-----B-o--E---?-------BBB---oo-----X---o--oE--X--M---E------X-Boo---B-----B----o---o---|
o---T---?----oX------o-|Mo---B------------o-ME-------BE?-B---E-??--------TE---X-----oEo-------E-o------B-o--Mo-------o-o-B-X--B--------B---?E--o?---oo-----?-ooE-Bo--B-M-----------oo-?---------------o-
--o-|B---------------X-X-----E-X----o-E-|--o-X--E-B--|M|-B--oMo-o?---B--oX----B------------o-------o------o--?o-oo-o----oX---o--?---o?-o-o-|---M-----o---?-----M-X--oB-E------X---EXM---o-------o--T---v
XM----------oo---X-----o-----?oX-E---MM------B----oX-X-X-B---o---------------M-M-------o-?|-o?--?--o---o-----o--E-X-o--E-Xo--?--B--X-B---EXX--|oTEME-------M-B-E-oM--B--------|----------B?------o-X-T-E
|oo-----M-oo----?X---o-B-----oET---B---T-E---B-----X-o---X----ETo---o-B----o---o----?-o------oXToX----o-----------oX-M------M-B--------?---B----XBX---X---oX?Xo-M----XT-M----------T-----B---Bo--o----oX
o-B--T---o-----MEB---oXX----------------?-------o-BB-----o----------o--B?E----T--------XB----E-X---?-B-----oEo-|---o-B---?--------?-----------------?----o--oo---?o--TXM-oo-B---B--X-----o-T-B?--X----ET
B-E-MX-?BE-o----B--TB---o----------o----E-------o------|--M--X----E---o----o---BE-------o--?-M-X--BoE----o-------------o-----E-o--B------B----E-----XE---|-------o-----o--o---Bo---X---o---X--------?-?o
M---o--B---B--o-o??--B--X---o-------B---M-oB----|----B---oBM-o-B-M------------------?---------o---o-----E-----B--B---o-M-----B--?-----M--o----M--o-----o------o------o-?------oX--oo------X----B------BB
Xo----Xo--oo----X----|B----BM-----------o-|B--B------BX---Xo---B-B----?T----XX---M--E------oT---o?-------M---o-o----M|--ooB-----E-----o---B---o--MB?---M------B----B---o---?o--T--?-X------ooo-E-o--T?E-
mXXXoT|oEEXBXM-oX--XoX|E--ET|-|METTE-MXTMBXo-TX--M-o|TE-|-|X|MBT-EB-BTT|---EBX-XXEX-XE--BEMM|TB|-o-?T--E--X-o--||-E-B|?oMXEXBEME?Eo?--E|B--|TM--TT|T-|-|TTBoMoEoX--|-??E|o-|ooB|-B|M--XEXXo?|XMM|BoE||??
XXXXXXXXXXXXXXXXXXXXXXXXXXXXXXXXXXXXXXXXXXXXXXXXXXXXXXXXXXXXXXXXXXXXXXXXXXXXXXXXXXXXXXXXXXXXXXXXXXXXXXXXXXXXXXXXXXXXXXXXXXXXXXXXXXXXXXXXXXXXXXXXXXXXXXXXXXXXXXXXXXXXXXXXXXXXXXXXXXXXXXXXXXXXXXXXXXXXXXXX
