?--o---o----o--X-----oB-oBB--BX---E---Bo------X--E-o-|X--B--|----o-B-----------o---T-Xo--------------o----o-o--o-------B------B--------E----E--Xo-Xo--B--X-o--X---oB------------o---Bo------X-----o---oE
?--o-?--oE--------B--?B--oB---E-B---------T---|E-----Xo----oXo--M----o------o---?-o---E------X-----oBX-----------M--M----X-o---To---X--MM-E-X--E------X--o-----?----oo-----MBoTB----oX-----o-----o------
M---ooB-----o-o--BoE--o------------?------Xo--XM---oo-----o----X------------o--Mo-oo--M--o--E---M----B---?-------|--o---o-?---oXoX--X--o------------------EE----o-B--o-T---o-?X--M---X-X----M----?-E--oB
o----E-Mo-----XB---B---------o---B?o-o----XB--B--o-?---------B-----X-X?--Xo-o--o----XEo---M-----X--X-----XXM----oX--XE-EB-oo--oE-o--o----------------|---XM--o--o-X-oooXB---o|o|-------EB-o--o-------E-o
----oX-Bo-o----o---oE---ooo--B-o-oo-----------o----B-------oXo----------E---?--------M--B-E--------o----BE-o----TB|-E???-X------E---XM----------o--o----B-B--ooE--------o---E--X--------X------B------oX
|--oTEoXoE-Xo-o------o---o---o---T|----o------?----o--o-----X--B-----MB--o--o--Mo-------o--B-------B-o--X--Xo-----X---o--|-?M-M-?--M------oBo-B--X------o--oMB-B----------oB-----o------o-------MM----MT
|---|--B---X-oE-E--B-----o-|---|BX|-M---M----EX?E-----X---?o---ooo---X-E----o------?-ooEo--BBE---o-|----X-?o-----Bo-----M|Mo-EX-B--o-E-o-M-o-------------oooX--o------o-------|--------oE--o-----oo---||
B-----oo----o-X--X-Xo----M-|---X-XX-----X---B---X-----o-ooo------X-----?---E-----oo----M--?B----EE---o-----?----------B--------------?-B---B-oE-----------ooo---oE---------o--X---o-M----oEE-MMo----o-|v
?------|M---o-E--------o-E--o?---o--------------B-X---?------oBT-o-o---B-B--------?o--E|-?-o-----M----Xo-X--Eo---o--oX---------X------------------X---o---X-------M--X--M---------EB-oo------X---B----X|
|---?XXX------?-M---o------------B-----------oE-------o--X--o----X-------E-----o--o--------B-----o--M-X--X------o---X------------o--B------------B----o-ooo-----?--?-X-----?-B-X------X----------o----BT
X---X--B-B--EoXBo|E-----------o--------X-----X---o--oX?----o-?-----EB---o--o--oTo----------Xo-------E?B----------B-oXo--o-E---XB-----------------o----B-o----?-----B-o---o-----oo---------M-------M-o-B-
?---o---XE----o-E----X-oo-ET----?-o--------E-o-------X----XE-T---o--B--o-----oEX--o--o-o-o-E-o---oM-M--o----o--o-----X--MoM?o-oB--B-o-----o--X-----?--B-o--------------o-X-------|-?---B-EB--BE?o-o---E-
--o--o--XB----X--o-----X--X---o--------?-B-Mo-----------XB---------------o-o-o-o-B?o-o?----?-------B------BX?-----o---|---X--X-----------------------o---?o-o---E--------Eo--B----ME-o---?---XMX--BM--XX
M-B----BoXB--?XB-B-X---X----------E?--XX---X--?-XM-E--o--X----o-------B---o-----B|B---EoB-oo?---M--X-E----EoBM?---XoE-----X-EE-o----T-o--?---o--oMBBBX---Eo-----M--o-X-oBM-?-B--?-X?T--B-E---EBoB-----X|
m|oT-TTo-||ET-TX|T-|oTBBTM-|M-oEE-?---TET--ooT--oBo?MXM-oB|-|-oT|X?-?XT||o||T-oT||BT|XM-X|o|ET?-E|-TMMoX?E?EXE|oM||oMX-?|XB-?XM?BE|-X-?MB|E|oo--oE|BoBEE-?TE-|--X-B-MTM?|||To|BBT-XEX-TEXXE|TM|T|TEXBoXT
XXXXXXXXXXXXXXXXXXXXXXXXXXXXXXXXXXXXXXXXXXXXXXXXXXXXXXXXXXXXXXXXXXXXXXXXXXXXXXXXXXXXXXXXXXXXXXXXXXXXXXXXXXXXXXXXXXXXXXXXXXXXXXXXXXXXXXXXXXXXXXXXXXXXXXXXXXXXXXXXXXXXXXXXXXXXXXXXXXXXXXXXXXXXXXXXXXXXXXXX
