o-o-----o------B-------X-T---o-o---o-o-o--B-------oo----E-o-o------B--------BBE-E-Xo-o-B-o-o-E--------o---o-BX-B--o--X-------o--o-----------B---B-X--X-o-----|---B--E---ooE---E--B----EXX-X---X-----o--|
oo-oB|--B-----oo-X----M-BX----------Eo-XB-B-----oo-----oM----M-B-------E----oX----oMX-----------?-E---------o--Bo--B-----------o-M----B---MX--B------|---?----o-oX--MoM--o-o-----oM-----X-B------o--X--T
|----|-B-E---o--BoMo-o----BE--?---------------X-o----MM-----------E---------o--E---B----oB--?--------T-ToM-E-o--ooE--------o---?oE------E--o-BX-----------E-----ToB-o-o----B-------?---XB------M-Bo-----
|X--M--B-----B-----M--E---o--M|-------?----?B-B-E--o--o---o-----M-?-EB--o--o-X??---XE?---B-oE-------X---o---B--------B--TB-------M-----------oo-----?---EoX--o-BX-Bo-Mo-?-o--M-o-o---M-To---?o---------T
M|--o--o---o-XT-----?-----o--E---B-oo-X--M--B-T-?------E----------X--o-T-B--X--X--To?--o-X---X-T------------B-X------Xoo--o---o-------X--Mo----E---M-o--ME-M-B-X--BoBoX-o-oB--B-E-BX-E----T-B-------o--X
oX-B--o-o--M|B----B--X------E----B-?--------o-----------XX-?oEoo--Bo--M-o---o---o-----B--o?-------?--------M--Bo-?M--o--------?-o-----B-?------XM--oE----M---E----o-o-B---oo--o-?X-o----o---------o---BE
EX-T--------X--------ooo---B---------?---?--?--M---------o---B---M--?-o-E----?--BM---?------oT--X|-----o-M---X-BoBE-?-o-o-----|-----E-E-B--BE---ooo---B-oXoB?-------E-E---------o-M----ooo--oBoM-M--?B-B
B--|----o---------------M-XX------o--oo-oE----?X-M------B-oo-B--Mo----o-X--------|-M-E--EBE---B---o---o?--o-oX----B-o-------------o-?BM-o-Mo?--o--B---X--B--B-|-E------o---?---B----------B-T-?E|X-oB--v
X-MX-BT-ooE----o----B----------M--M------B--Eoo--BX-----E--MB-o--T------X------B--Bo----B-Bo-----o------MB---o--B----------E---M---Mo-X---Bo-oo-EMo--T-?-T--o-----E----E---E----?-X--o-X--B---B-----o-oX
B----o--o--T-E-o--o-o--------|M-o------B-o---M---BB-B------E--M|---M--X-----?--Bo-----EM---X------------XB-oX-o---------?--X-------oX-X---X---T-X------X-X-------oX---E---o-------Eo---X-M---BE--------T
To-----Mo---EX------B-?------XE----M---o--M--X---o-oo--------Bo|---EB--o-o----E--M-EMMB----Bo----o---E---E----------?B--XB-B--E----?o-o?--E-o---o------ETo---oBo-oo-BoB--Bo--oX-------------ooM----?-?o-
M-MBB--o----Bo---B--oXo---o-o|M-------o----?o----M-?-o-------o-XM-EX-EBo------X---B?oX----o------o--M-BM-B|E-Mo-B----E-o-oM--------o-o--X--o----MoM------o----X-Bo-Xoo---EE---oM---E--X-o----BB-B----o-|
--o-X--Xo----EM-XT--X--oM----XXE-----M---o-XB-X--o------E----o-XX--o-Mo--------?----Xo----?---------X-oX-BXX-E-EB---------o-----oBB--M---------------B?-------X|-?-T------?---------B--oB--E?o-----|---|
o----M-o-----Xo-X--X---?|----XB------B------o--B----|---Bo---?BEBM----?B----TE-|--?-XEX---B--XB-?-B--B-Xo--BBX-?B--------M--XX--ooX-E----?-?-?-----o--BM---MX-|X?-M-X---T-B----oTTo-o--MX----------X-XXM
m-MTMoB|-?B-EEXo---BTMXX|oo|oE|---X??o|-TBB-??BBTMEo|B?-oE?-|B|M|T-EEEToE-oB|M|XMBE|EB|T|oB|oTT-XToB-TMo?TXXB|-oX??ET-?M?---XX?o-?|oM-XE-|BT-B-T?M-?MB-EoB-ToT|BBEo-|M-oX|ET-o|?||-EoB|oXTo-X-BoT|BT--Xo
XXXXXXXXXXXXXXXXXXXXXXXXXXXXXXXXXXXXXXXXXXXXXXXXXXXXXXXXXXXXXXXXXXXXXXXXXXXXXXXXXXXXXXXXXXXXXXXXXXXXXXXXXXXXXXXXXXXXXXXXXXXXXXXXXXXXXXXXXXXXXXXXXXXXXXXXXXXXXXXXXXXXXXXXXXXXXXXXXXXXXXXXXXXXXXXXXXXXXXXX
