o--X-------B------o----T-o--X|---------o--o---------oo----B------Bo--o-----oB----o-----B-Xo--B--B------X---oo---oE---oo-o--EX-o-----o------X---X--X-oo------E---o--oB-----o-o------o-BX|------oBo-o-X--X
----------o--M----M----XX---B-----o-?---M--------------?--EX-----o---------oX---oMT--oE--o---B--B------B-oo---o---B?-B-----XB---M--o--o----o-------B----oE--------BT-TTMo-----T--o--o-o|--------E-oM---X
|--XM-------oo----------X------X-o?-o---B--------------o---X-o----o---EX-------M--------o----o----E----oo--M------B---|-o--EX-o-B---o----o---------X-B-E-----XB------------E--------?--Xo-?-----?-o----?
To-TTo-------X-BB-------X------o-o---T---------T--E-?------X-?--B--------------o?B---o-----o?-----M---o--o-o--o---o---|-o-M----B-o--oB---------B---E-o-------XB-|B--X--o-?------B--?B--oB-o-----oo--M--M
Bo-XXo---o---|BB-oBoM-------M----X--?----?-----XE-M---o--XMX-o----X----TB-----B-o---------ooo----EX?--E-M-o---E-o------?------BX-BE--o------o-MB---X----?----o-EX---XB-M--?-X-oMo--X-o------B----X--o--M
oo-o-?oo-?----oo-----XE?--o-X----o-oB-o--X------?oB-----oT--o--M--o---o---Bo---X--TE-B--To------oB---oX--E-----EX-oE?---o-o---oE-----X---BoB-?EX---oo-----------o---|--X--o-X-B---Bo-M--o-----o--o-----?
MB-o---X----|----M---oB----E-----------X---------X-o-Mo--X----------------X----Bo-XB----|-M---B-----EXB---Mo---B---?|-|--o-----B---M-X---X---BMX---?X--E----X------?--XT-X-------------oo--o--o--XoB---?
?BE?o--X--------oo--B-----BX----------------o-E----oBoE-M--o--T---------M--o---oo-XB------oM--o---B-Xo--B---------BB-oX--------------E----M----oE--X--oM--E-o--Bo?T--?o--E-?-----------MoX--?--B-Bo----v
o-Bo---o-----M---To----o--EX----?Bo--o---X----BX-oBT---oo---?-XE-----EM----o------o--B-----B-E--------XM----------B--Bo-oX-------o--------o---E-B------E--?---B--E----X--B-------oEo-----o--------o---o-
M-E---o-----oXEE-X----?X-E-T--M-oX---B-----?-ooX-BE------B--TX|-MM---Mo-----|----Mo--B-XE----M-B----?--o----o-oT--E-E---o--o----o---o-o---o--EM------M---o------E----BBM-----B---|X-?M-----?---o----M-XE
EM--MBo---X-----------EXoB----o--X-B-BXo---------B-E-o-B-o---oX-oo----?-B?--X----o-o?o-oM-o-oo-oo?-M--o-o---o-----BMM---BM--o--o---------E-EB-X------X------E-B-B-X--TBX--o-Xo-Eo-o-|---------oX-E-To-XX
oo-?X---o-------E-M---MX-B-----------B-T-----E---B----X----o--o--o--o-X---X---EX-B?E-o--o---X-o-BB---EB-ooETXM--E?Eo--Bo-o---------------?-?X-o-M-M-o-------B--------X-o-oB-X--X-----B---------B-B----XT
X-E-X---M-Bo------X-E-o--B------------------|-------M-E---B------oB-------X----B-oEB--E-----B---o----X|X------XMX|-----?--o-Mo---oM--------o--?-----o--o-o---------EXo-o-o-----EMo---E---------X--o---EE
--Xoo-o---B------Xo--oo-o--BT--X-B----------X-----T-oM-X-M-----o-------oB-o-E--o--BB?TB-M---oBBoB-o-EoXo------oXB------oB--oTo--X-|o-o-o-B-----E--o-----E-------o--Xo-|-MX-----XB-?-MB-|ooMoX-BXo-B??oB|
mETB-TE|-?-M|TEX|XME-M|EMB-|XToETBoooTMEMMB-oT-|-T|-oB-T-o-EE|?B--oTXEE-TT|B?TEoo-TXX|X-o?-?|oEoBoo??BXETE-ETMEEoTT-oEEEE-o||---|BX|-?M-XoXXE?-?-o|BMM--X---oo--|o|TET|-X|oM|B-oo|o---o||E||o|oTMBoX-?-|
XXXXXXXXXXXXXXXXXXXXXXXXXXXXXXXXXXXXXXXXXXXXXXXXXXXXXXXXXXXXXXXXXXXXXXXXXXXXXXXXXXXXXXXXXXXXXXXXXXXXXXXXXXXXXXXXXXXXXXXXXXXXXXXXXXXXXXXXXXXXXXXXXXXXXXXXXXXXXXXXXXXXXXXXXXXXXXXXXXXXXXXXXXXXXXXXXXXXXXXX
