|-o-o--------o-X--E---o---o--o-----o-|B-----X--oTX------------Eoo-X-B--X---B--oBBo----o-XE-X-T---X---oo---o-B----B--oo---------X---------Boo-oBB-oE-B-----------o------------T--o--------B---oBXX-oB--EE
BB----?-BM-M---T---X-Eo----E---oX-ME---o?--Xo-oE|o-?---ooE-------?-o---------o---o--Mo--EB-T-----BE--XM---|-E?---XMo--Xo--o-E-o---------X--------B?-B----M------X---B-M---o------BX-Eo?--oo-o-oo-M------
XX----o--o-----X-?-X-Bo-----E------X----X------X----?------o-----E---o-----------?|o-------X--o-------E-?-XMB----o-o-E-B----Xo-Eo----?------B---------o?----------?--X----------B---ME-----------B------
T-o?-oo?-------o---ooo-------T-----E-|------MB---B--B--o--oX---oM---o---?oEE---oXE---------X-B------o--Eo-oo-o---oo---ooX---B----M----T--B-To---------o--------o--o-?----------o-----M------oE---E---X-E
|--XXo-oo-E-ooM-o--------M----?--o--MX-B----o-XM-----B-M------o-o----B-BX-X-M?---------EMBoo----B--M-E-?B--X---o----B--oo-------M-o----o-o-|Xo-o---o-------o---M------E-Bo--------B--B-|----------oX-o-T
?-M------E?-----MoX-----|B----o-Xo--X--o-----X-o-X?--X-o--o-B-?-o-o-E--oE-E-Eoo---------B-?M--X-|B-o-?|----X-?-o----o---?---X-?---B--B--o?--E?--B--?|o-Xo---o--o------X-XBo-o------o-oMX---T------B----o
o-o------BTM---E|--?M---X-o-----X----------X-EE--E--Moo--oX-|--M-oBoME-o--?o------o--B--B-X--oBEX--XoB---X-o-XB-oo-o----X-?-X-B------o-------E--oM--X-MXB---------o-o------o----oB-o--------M---B--o---M
T---------X----?Xo-oo---X-E-----B---o|-----o--X--?---oM--oo?XX-B-oB-BB----o-----T-oo-X--o-------o--EX---BE-?-oo---------------X?--B--------M-M--X|-----o-o-|-B?---?BX--------oo--o------B---Boo--------v
B----T----E----oX--o---o----o-E-o---oX-----T--o--o-------o-BXTMo-E-ooE--B-----------o-----o---T-----oo-----X-M---Xo-----------o-o-X---B-BM-o-o--BX--E--?-XoXBoooo-X-T-o-------?-------X-----o---------oE
o----X--M--oB?-?T--T--M--M-----o-----B----o-o------?--------o--o-----X-X-M-?--------------EXo-|Bo------------X---B-M-----o-o-----X--B-B-oB--B----o|----B----o-E-o-E------M-EB-X-------BB-----oo-------XT
X--?--o-BM---o--X-----o--o-----o-o---o----EooXM----B--------o--B--T--X-o-X---o--------o-|M-oo--o-----B-------------X----?------------M--o--------X---o--MB--------?M---------M------o-TX----B---------B-
|--o-----o---Mo------E-B--?B-o-?M---------MM-o--MX-Xo--XM----------X-o-o--M-------o---o-XX--B------o--------oXXoo-o-----o-M---------X-X----------------BoX---E---?-B-oo--o---o-T----BMXooB---X--------EB
---------Mo-?---Xo--M---?--X---E-ooMB---XBBo-------o----E---To-B-?------M-o-------------o-o-o-oB-----X-X------o--oo-o-----o--B--oo--|-----o--?--B-o---EX-----MMM-o----o-oo--M-------|ooo-----oX-o----E-?
B--XM----o??B-----MMX---Xo-oo----M---o--oX-?-------X----M|o-X--X-X--B?--o--------?---?---o--XMX--------|------B--X---o-T--Xo-----o--XB--oMB--o--B--|B----B----XE---X---BM--X--B--E--X------?---o-----B-B
m-|BT?-EBET-oo?E-?B|EXMM|?o-BE--BT-TToMoMB?B--MoETT|-o-oXXBT|?E|oEBE|o--To?|X---MBEoMX---EMEXTE|E-BTBXE|B--E-EEBoo-|TBMX|-|oT--E?oB?oTMMEBo-T-BE|o-XB--B-Xo-|ToXT|-B?XTXEo-||XoX?B-oo?--|MM-TX-?B?-?XXo-
XXXXXXXXXXXXXXXXXXXXXXXXXXXXXXXXXXXXXXXXXXXXXXXXXXXXXXXXXXXXXXXXXXXXXXXXXXXXXXXXXXXXXXXXXXXXXXXXXXXXXXXXXXXXXXXXXXXXXXXXXXXXXXXXXXXXXXXXXXXXXXXXXXXXXXXXXXXXXXXXXXXXXXXXXXXXXXXXXXXXXXXXXXXXXXXXXXXXXXXX
