TBEEX--X------------TX------X--o-X-o----Bo--E-o--B-----o-------o-o|---B----------o---o---o-X-X-B--B--BB-------------Xo-o------B-X---E-X----------E--o---o--X--X-|---X-E----oB----oo--oB----o--E-B-Bo---T
TB---?-B-??-------E-|o-----X-X-----o---X-----M----BM-ooX---o---|--X-oo--XT--M-M--E--BM---X-B------B--o-o----o?M----E-oBo-?------------------X--?---oE----o-E----Xo--Xo---?---X-B---X-Mo--X-Xoo---------X
M----o---B----------X------X-EB----M---X-o-----X-o-o--?X----o-o-----------o---B------------X---o---o-----oo--B----o-oE---o--o--o-----o------o-------?T-M---?---ooMM----M-oo--E-Bo--E--ooo--|-----o----X|
EB----E--o--T---M---o--o---oB---XBE-oMEo---EB--E----MM--EB-------E---?--o-----oM--------------------Bo----Bo----M---oX----Bo----------------BX----X----BEoXooo-----XB?----o-----E---------o-o---Eo---XXX
Bo----B-Moo--B-M-Bo--o-----M--?BTo?oXo----o-XM-------X--?oM-o--E-?--oB-------B?-----o--o--|---M------X----X-----BB--ooo---o---------E--o-o---o-oo-o---ToB-X--?-----oo---X--o--o--------B-o----B---o---B?
M-M-X---|--E-o-o-XBo------ooE-BB--oM----?---BX|--------oo---o---o----o----B?--EB?--B---------oB-E----E--X?------oo?----o-?------?oM-B--X-----|----------o---BXT------?o--?---XE------EBBBB----B--------X
B-----o-Xo----o-?o--?----M----E------B-B------Xo--o-----o-----B-o---------EB----E-?--------X--o--oo--B?---------------o--Bo-M|---?-----------|--?--M--------XBXT---------o?----T-M----oo-X-|-X-oMM-----T
EM-----XE-B---o?Eo--X----X----B-----Mo-X-?-----M-oB--E-M--B-o-E--------B-o-BX----------o------B?-----oo-o--o-B------T--E-B--o--B------o--M---X-oB-EEoX----B---E-M-o-o-----ooB----o--B------XX-o-XB--E--v
o--EM---B-XBM---M---BB---o-oo-------o--o--XM---o-ME--XEoo-o-|X---Eo----------Mo|-M|XMooX----?-oB-B-B--o?---?--o?---M---M-------o--------ET--o---X---?--EE--?--B-----?-ooM--?----------X----ooo--X--XB-o?
o-?MEMo-X---o---o-----oo-B--BX----oo---E---X--o--o?-----XBXo-o--oM-X--o|M-----?-o-X------o-B-B-o--o----X?M---------E--XX-----oo-T----X--MX-----------E-?-----o------oM--X----B--E------oBBM-------B-----
X-XXXE----o---o-------X-----oo--T------X---oMo|E---oM---ooE--X---T-Xo-oX-o--B-o---o------o---E--o---------X-------------X------o----oE-oEo---------X--------?o--B---------|--T--B-------|-o--B---------T
--o-X?--------E---X--E-------o--X------B--ooE--X?--o---oo--o------EE-X----B?Xo--X-o----------?---ooM--o---oBB-------?-----o--o-o--M----MX--o---o---o------------B-----o--|-o--X-o----------M-o---MB--B-|
--o--o-----o--M-TE-------E--E---o-X?-----------Xo-----------X--o-----o----o-X--Bo-----?--------o---E-----oo------B--B|--B----E--o------oX-----o----oT--EB------o|--?--?--X----------X-oB-o-o------o--B-E
|?--X--E-----BoX-ME-----oM--B---oXXX----M--X-?TXM--Bo-----o--o--o---ooo-----E-o--o----Xo------|--E--?--B-?---BBX--o-oXM---o--MMM--?--??Mo--BXX--|---X--Mo-----o-|--B----?oX--M-------XX---T--B-------BX?
mo-oB-oXo|?--Xo|-XM|E|T-oE-TXoTEo|XB-TXoBB?EEB|BB--|E?EX|E?--TT-o--MoT-Mo?MoX?|?-?-TET|X-oE-EX|?-?--TB?BET--|o-EEoT-T||MT-o-?T-TE-To|BBoX?T|-XEo|o-MET|-|-?MB?Eo|o-TE-E|XTTX-oETToM-oB|BB-|TTT--?o-EBXTo
XXXXXXXXXXXXXXXXXXXXXXXXXXXXXXXXXXXXXXXXXXXXXXXXXXXXXXXXXXXXXXXXXXXXXXXXXXXXXXXXXXXXXXXXXXXXXXXXXXXXXXXXXXXXXXXXXXXXXXXXXXXXXXXXXXXXXXXXXXXXXXXXXXXXXXXXXXXXXXXXXXXXXXXXXXXXXXXXXXXXXXXXXXXXXXXXXXXXXXXX
