B-----XB-E--B--o---o----o------E------oB------Bo-EB-X---X-----------B-----o-----------o--oo-B--XX---Eoo----o------o---o-o--X---o-B--o---o----E---oBX-o---B--o-----o-----------X----E---X----BEX----ooo-?
B-----X-?----o-------o---o-E-M-BMo-----BM-E--M----o--------oX----?----------o---B--o-B-T----T--oE--o-------?-----------o--oB---E-X----------E-o--Bo-----o--o-o--B-MB--o?--X---o?-E-M---o--X---------?-oo
X--M--o-o---------|M---??----X--B-----EE--BB-X--o-M----Eo---BM----Xo-----M--MB---E--o--X-----M----o-----o--X-o---------o------M------?X---BM----X-oB--o-E------o--o---M--oo?-EB-----?-M------------B--oB
E---M--XoX---E--?oX---Eo----Mo---M--X--M--o--E-----------E--o--?------?--B|-Xo-------o-X--oM-o-----MB-------------B------?--o-o-----M---ME---T-----o---oX?-----E--------o-------------o--?-E--?----EoXXM
|-oBooTX--M?--?-EME?---B----o------oEo-X--M-X-----E------------o---T-BXB-|--Bo-?----M??--E----M------B------TE------------------o-Xo----XB---XB-------oo-ooM-----?------o---o--o-o----X--oM----------ooB
|---|-X----o--o-?-?o---|oM----XB--o--oXo-B-----B--X-?X-o-------M---X----?X-o------o-E-B------BE--o|oBB----MoXM-o----oX-oo---?----Mo-----------Bo---?-To--ooXX---B-------B-----?--X-BB-B--o---E--------|o
-E--X-B------o----X-------X-o-Xo?----o---B-----Xo----Xo--oo-o---o-Eo--------o-o------oBo---M--B-o-------o?-ooo?E-T?-----?o--o-M-?o-o-B---E------?----|----Bo----To------BE----B--o-BE----X-------------B
?B--o?-?B---o-X------EB-Xo---oB-o--oB----o-----T-----B-M---?|B--X--o----------B-------o?---E--B--?------?--XBoo-X---MMXB-?-B-oB----T-Bo|-?-----Eoo---X---XXo--BXX-X?oo---?----o----X----o--------oXB---v
o-o---------o-XB-------ooo--E-----o-Xo----o----|-----o-o---o-BX-|?-o------B-------o-o----X--XB--?Eo--o-----E--------|--o------o------|-X-E--------B------X-----Eo------?-o----o----X----E-------------B-
o-?-----------oo-------M---------Mo-oMo----?-T----------|-T--oX-|---ooo------BX-XoEo-----o---oB-o?---------?-----oB---MM--o---o---B--X-o---E-------------Eo----X-------BE--o-?----MoX-o---------------oX
-?-----MM----o|-M-----To-o---o-o-----oXoB--T|----oX------X-E-o---o------------o-o-B--------B-----E-ooB---oE---X--X-M-o----X----M--X-----X---X-o---------MMoo------o----EXo---o------oM---o-BE---------oE
|------Xo-X--M-o-B--o-X-Mo------o--BBoE-X-oX--M---o--o-o-B--?E---oX?----B-----B-oT-MB--o-?-E------oX------M------o?B-E-oE-o---TX-E---X?-oB--T-------?--o-o|-----o-o--B??X--o--X---o-BB----BXM---X---o--M
X-o--?-X--E-o--X----BoB-EX-----B-o----M-o--o----M-------oXo-XB---B-X-X-Bo--o-?-------o----M---X-o--o----|-X----?-Eo-E----X-E--XB---E-BoM-o--X-----o--X-MoMX-o-E---M--oooB-T--------?B-o-oM-ET---o------E
|oBo-o-B--?----B-?-M----ME-----E?B-----E-o-Bo?--B?X-B---XB--o--o?oE-BX-T-o---B-----o---X--X-E-BBoB-Mo---XEo-?---o?--M----B-XX-oT---?--?T-X--|-X-------?--ooX--?--?XX---M-oX----??--oXX---X--X-M---BX--BM
m?--oM-TE-oT-BBBoBM|MBT|EMB-TTo?TE-BEX-?XMXBXBEX-X-BET-oBoX-o-oX||BTEXXXMT-o-oETo--?B-XE-E|EB-E|-||B-oEBX?o-o?--TEoBTBM|M-ETBX?|E|EB---|-BT-|MooBEM---||?-BX-TooToTo-E|B-EEX--||o|EMXB-MET--XoBBoB-oXX-X
XXXXXXXXXXXXXXXXXXXXXXXXXXXXXXXXXXXXXXXXXXXXXXXXXXXXXXXXXXXXXXXXXXXXXXXXXXXXXXXXXXXXXXXXXXXXXXXXXXXXXXXXXXXXXXXXXXXXXXXXXXXXXXXXXXXXXXXXXXXXXXXXXXXXXXXXXXXXXXXXXXXXXXXXXXXXXXXXXXXXXXXXXXXXXXXXXXXXXXXX
