------B-E-----X--BX-----Bo-----To--B-T-o-XX--B-XB-B-----XXB---XB-X----------oo-B-oX--o-----X-|-------Bo---Bo-XX-o-----oo-B---oXXo----B-------o---Xo---B-X---o----------B-o----B--o------------B------o--
--B-----X--oM--o-EB---B--------X-----X----o-----B--------B--------|-------oM---?-M-M---------X-o-----BB------B----B--XX?-oT-X----o--oB---o---|---E?-------------?------oX--?-----?--o--------------MB---
-oX----EX---X---------o-o-------------o-------------------X----?--X----B--X-------o-o----------------------o---Mo----oE---X-B--B-----------------X-----------------M---?X-E-M----o-----------------B----
-T--EMB--------------o--M----o------Boo-M|--M---|--------o-----E--X----------------|----------------------B----oX-o--?X---o----B------------------M--o----X--------X------Bo--oM------o-o---o?------o---
-X-EXBo------B----B------oo---------XM--oX--B------o--o-Xo---B-X--Xo------X--X-----X-X-o-o-oo-------------X---------o-B---oB----------o---o-o-----B-o|---?B---o----o-----oBB-XXo--?---Eo-----o------B---
--o?--B--?---B------------o--o-?X---Bo-XoT------o-----o--M---B-------B----X?Mo--o-----o------E---------------------o-------X-o----------E--oM-----Xo-X---------oo--X-M----X------XB---M--o--------------
---BX-E---o---?------M-----X--?oB----?B-BX--o------o---oE------------o-B---XXXB-?------------?--o---B-o----X-o-o---B---------?------?---B--o-------XX---o------B---B--------o--X-XB-----?X----o---o-----
----T-?---X-o-oM------o----XE-o-B-X---oo-X-MM--o-------oo-B-------?-----------X-------?---B---------B-X--o-X--M--X-o---o---------oM---B----o--------X---MX---------X---oB-----?--o----?-Eo--X----------v
--o-X-----X----X------------B-----o-?--X---XBBXBBo----|---X-o-------M----X-----o-o---BB---B--o------XB-o-o----X--X-----------o---?----XE---o-o?-E------XX-----B---------o--M--o-------o-X---B-B--B-----f
-Eo--o---o--X------o----o---------o---------TBo-Bo--B-X-----------o-X----B-----MXE---oo---E--?-----E-X-----E----o----------o------|---oM---oB---X-X-o-BoB---o-X-------ooX--o---o--------oo--E-o--------f
-XM--o----o-o-----o-----X------------------MXoB-----------M-----B------o?X------XX----B---B-----X--B--M----?-o---o--X-----B-------X---X-----B---B-X---Xo----B-----E------------------E-oo-X?M-X--oo----f
--X--X------X----?--M---X-----B-X--B------Mo--X-----------o-------?----?o--o-o---X----T---------B---B-X------B-----?B-oX--B----------?----E-----------o-M------o--X-----o---oXo------XB-B-BB-----------f
-o-----------------XE--o-X------o--B------o---oX-M-----B--B------B----M--o---X-----X-MX---?---o---E-oo-------------o-?-E------------X-----?-?------B--X-----------o-oB-------X--BEX--------X------X----f
--------X-----?----oB---oB-|-oo----X---o--o---oB--------o-Bo-T--X---E-X--B--------EE-B-o--B---o---B--?---oo--------E-B-B---o--?B-o--XoX--BX---B--------------B----X--o?-----E---X-T-B---M---B--M--E----f
m-----TE|B-XTXXMB-B----T---|--?B--X-oXMTE-----T|?-XBX-E-|--|-|----E-?X--M-?-|o|BET??--?T|EE--?BTo?|--EX--EM--oB-M--BB-MX?-TMM-B--X-ooBBo-|--?T|--T-E--X----?oBEE---|-||--T-|M-X-|-|TBT-XTE-BoX-TTEB----X
XXXXXXXXXXBXXXXXXXXXXXXXXXXXXXXXXXXXXX-XXXXXXXXXXXXXXXXXXXXXXXXXXXXXXXXXXXXXXXXXXXXXXXXXXXXXXXXXXXXXXXXXXXXXXXXXXXXXXXXXXXXXXXXXXXXXXXXXXXXXXXXXXXXXXXXXXXXXXBXXXXXXXXXXXXXXXXXXXXXXXXXXXXXXXXXXXXXXXXXX
