EB---BX----BXX-----B----X-----oX-o-BX---B-o------BXX-B--o---o-X-o-XBB-X----o-B------BB---X----B--X--o-B-o-X--X------oXo--------o-XBX---B------Xo--X----B-X----XXX---X-------o--ooX-B--------------B----o
|------------------------X-----o-------o--X-E---------o-----o--o-------X-------oooo---------------------o----------oX----B--------------------------?---o----------------|-----------------o-----o--o--E
MX-------o--oo--B-----o------oM------o-o----X----o---o---------X--------------E--oB-----------o-oo-oX-o----ooo----o------------o--Xo--------------X-X--o--o---------oo---X-o-----------------------o---T
-o-------o------o-T-oT--M-----B------------o------o----o-----------------o---oX-----------------?-----------X-X-B--o--------------ooo-X----oo---o-oo---M--X----------o---------o------------------------
X-----------------Xo-X--X-------------------------M----ooo------------------------------------------B--o--------o---o-oo---o--o-o-M---B-o--o------------------------oX----o-----------?--------o--oo---T
Bo------o---------------------o-o---------X--o--------o-----o--X---------o-o--------------------o--|Bo-----o--B-o---o------o-------o---oE-----------X---------o--------B-------M------o---o---?--------E
-B---o---o----E---o------------B--o-------o------o---o-----------o---------o-------o----X----?o----X---------ooX-o--o-------------------?-------------o---X----o-o--X--o-o-?---oM-----X-------B---------
B-------Xo-----------------o---o-o--------o--o-------o---X--------o-----oo-------o------B-------o----o--To----BX---o--o-----------X-----X------o----------X------o--o---M--X-----ooB------------M-o---?v
B-----o-BX-------------o-----X--o----?----BB------o---o---------o-------o---------------------oXX----X--X----------Xo-oo----X-----o-----o---X-o----o-oo------o--------B-o-o---o--M-o---------o--X---X-o|
E-----o---------o------X--oo-X-o-----B-o-o-?----X-B---o---------B-o----------------o-----------o--o-------------------------B--------o-o----B---------------o-o------oX-------E--------o------------B--|
B---Xo-----o---------o-BE-?--o----------o-o---o-o----XB-o----------o------------?------------------B---------o-------------o--o----------------o--o-o----o---------o--o-o-----M--o------------B-E-----??
-o--o-----------o-o-----X-o------o--------?----oX-----o----B---------o-oo--oo---o?--B-X--------oo-MX-----------------o-o--------------------o---X--------o------o--o--M-------X------oX-----o-B---o----|
To-------------------o-----------o-o------X--o-----ooo---o--o-----B-----X---B----o--B-B-----------X-------B-B---o---o-----------------------B-o---X-o-----------------------------o---B--------o-o---B-T
M----B-----o---BB---X---X---ooX-------oo-----o----oB--------X---M?o---oB-----------B-o------X--?----o-o-ooB-XX-------Xoo-----X---o--o---o---B-E--Bo-------oo-Xo-?---------?o------oX-o--B------o-----o-B
m--E-To-oTBX?|Boo-?oBT---T-E-XBE-EXTMEo--oEET--To---XTT-T|-E|-X-BEoT-o?XX----B?B--BTT-X||E|B-oXBEBBToBoT--oX-EX-B?TE-T----oXXB-X--E-MT-XXE-oB|--oBB-Bo-?EMX?oEMBEoXTX?-BBBEX--M-X|-BoX--To--oXoMT?-T-o-?
XXXXXXXXXXXXXXXXX-XXXXXXXXXXXXXXXXXXXXXXXXXXXXXXXXXXXXXXXXXXX-X-XXXXXXXXXXoXXXXXMXXXXXXXXXXXXXXXXXXXXXXXXXXXXXXXXXXXXXXXXXXXXXXXXXXXXX?XXXXXXXXXXXXEXXXXXXXXXXXXX-XXXXXXXXXXXXX-XX-XXXXXXXXXXXXXXXXXXX-X
