|---------o-T----T-----------E-?----X------------X---------o-----B------BB--B-----o-------------E--X-X-------X---o----o-----------X?---------------M---------X-XB--------------EB---------?-----B--B--?|
X-o-----o-B-X---BX-----------M--o--o----E------o----B-----oM-----B------------------------------?--B--o------|------oEX--------------o--------------------------Bo-o------?----MX--------o-BM---E--o---M
|---------------------------o-o-------o-X---------o-------?-Mo----?------------E-------o------------------To-X-----o-BX-----?----------------------------------E------------------B--------BoE--M--B--MM
T--------o-----------------------o---------Mo-----E---o--?XoX-B----------------?-------X------------------Xo------X---------o-----------o---o-----------M----------o----B---o---B-------M----X--------oB
|--B----------------X--------?X-------E----X------?-----------X-------M------------o-------o-----X----o----M-o----o-----|---o-----?---------XB-----E----o----------?----o----?--E------------B--------ET
|--B-----|-------?--oo-------Xo-------B----B-----------------M--oo--------oo-------------B----------------o-o-----------Xo--------X----------X-----M--B-M---E---------o-B-------Mo--?--------B--------Bo
T--o-----X------oB--?-B-------M------------------------------X------B-----X---T--o-------|--o-------------o----o--------o-o-----------------------------o---B-------E-o-----E---------------oo---o----X-
X--?-----X-o----X-----B--o---------BE-------------------oB---X------X----M----X-E----E---X----------B----------M|-----X-----------o--------------o-------------E--o-o-------X--------B----------------ov
Mo----o--o-o-E-oX------o-E-o-----o---------X---o-T-------o--TX--o---B----B---TB-M----?-B---o--------o----o------X--X--o----------E---oB--B-X-----B-------------B---X-E----E----------X-o--------------TT
EB-----------?--X--------?-------o---------X-----X--oX------X----------------XB--------o------------|---------o----------o-------B---oX----o--B-----o---o-------o--X-X----M---------?---------------M-?B
T-o--o------B-------------X-M-|-oX------------o-----B-o-----X------M----------X---------------X---|-X---E-----------o----------?------B-------B-----o---B-----E-----X-----T------?--o-o-o|----o-----o-MX
X-----------o--o----o-M---o-o-X---M--------------M---------oB------o-----o----X------X------o-o--E--X---M-------?----o---------B---X---------XT------?----o---M--B--o----oX------XT-B---BM--------?---MB
E-----------X-o-----?-E----X-B-M-----o-------B-------o--------o----B-----X-----------X-------oB--?--------------o-------?--------------------XX------X-------B---o-----B------M--oX-----oX--------B-o-?o
T---X---------M------oX----o?--o----o-o-X----o---?----------------oX-o--------------------|--B------------B--o-----B------o---o--B--|--o------T--------------X---B-----------?X--o-T------------?X----Mo
m-|-M--|Eo--BM--o-T--o--E-B||----M-E-----E--X--|MoEX-o--o----B-TT-?-X-o-|-E-ET--------BT--XT---E-?---T-o-TB---X-X--X-----B---XMM-|-oX-E-|o--M?X||---|-B--To-?BE-B--oT|----o--o-----Xo---EM-TX---EM---o-|
XXXXXXXXXXXXXXXXXXXXXXXXXXXXXXXXXXXXXXXXXXXXXXXXXXXXXXXXXXXXXXXXXXXXXXXXXXXXXXXXXXXXXXXXXXXXXXXXXXXXXXXXXXXXXXXXXXXXXXXXXXXXXXXXXXXXXXXXXXXXXXXXXXXXXXXXXXXXXXXXXXXXXXXXXXXXXXXXXXXXXXXXXXXXXXXXXXXXXXXX
