|X?o--o-------oo--o-----------o--------o-E---B--X-o-oo--XEoo-----o---E-------E---o---o-----o---oXoo-EB--o----o-B---ooo-oo---o--o-E-----ooEo--------XoB----X-B-oooo-o---o-E-------X--------Bo-----------E
X----o---BM--oBEo----------o---o----o----X---------o----oB-----?--EBEB-o-MB-BB---o--o------Boo-oBB--Bo-ooBo-Bo-o-Bo--B---o--B-oooB--o--ooB-XB--o--------E--MB------B--B---o-----?--E-B--------M-----B--B
??--oo---------B-E--oo-------o---B------o--oo--o?X-X---------o-o-o--B--oo--o-o----o-o--o----|-oT--------------BXo----o--------X-M---BB-----o--oo----ooo-X---o-BB-o-B-----o--o-----oB-----B-------oo-oo-T
TX-------oo-----BB-oo-o-oX-MoB|B-X---?-Boo-B--oo-X-B-o-Xo-XoBBBoooo------oB-o-B---o-----o------Bo----|-oo---?-----B---------o-B---?ooo--o---oo-BB-------o---Bo-BoB------E-o--E-M-TBB---XBo-----o--BBB--o
T-o----oo-?o-----|o-B-o---o---X--X-oo--oB-----o--o----M-----X----B--Bo-o--B---o---X-BoX---------o-----Xo---o-----Mo--o--o------BX----------Xo------------EB--------BB-B-B-B-BB------o--E-------o---B--?X
-B---o-----oX-----oBBX-B------------E-M----B-------BE-o---oo----o---o-XooEo---B----To-o----o--BB-----E--o----o-----X--o-E-----?-X?-EM-o---o-?B-oo----o---Bo-o---Xo----o-----XoBM--X--ooBo-?o?--B---B-oBB
TXB--------------?-----B-X-----o----B-o-|-BB---o-o--Bo---?E-------BoB-o--B-Xoo----BoXo--------B-?-o-oB--B---o?o----B--?-B--XM-Bo--BBo--------E--o---o------------o--o-o-----oo------------oo-Bo-M--o---?
B-Bo----o-o-----Bo--|-o-?To-Xo---------o---ooo-oo------o?-B-o-o-B--B----------?-o-B--------oXo-o-oB----ooM---Bo---o-----B------o-o-----T-o---B----o--B---o---X-EB--E---B-----XBo-?----oB-----o--o--o---v
ooB-----Bo-o---?o--?--o------oE--?--o-------B--BoXBo-B-o-------oB-Bo--X--Bo----o--------o--oX-MBBBoo------------o-----BM---------oMo---Bo----o--Mo-oXo--BXo--ooB-Bo----E--oo--ooB---X-o----------o-----f
To-o---o-o----oo--o------?Xo--Bo-B?-X--?----o---?------M-MoE----BBB---B-oo----o--XB----------?--E--------o--o---oE---oB--oB--------BX-----X--B--B-------X---ooo--o-?X--Bo-E-------B?--?------o-o?-M----f
TX-B---o-EoB--o---o-?----o-B---o?E-----X----?--o----o------Bo-E---B--oBo---o-|B----------o--o--?B--------------o-B-o-E-oBo-o--oo------------o-------B-------oo----oXoXB---B--------Bo-E--B-BB--o-o--Bo-f
EB---BB--B--oEM-?-o-X?--MBoo----XB-----X-oBo-----Bo-M--o--oX--B-o-------Xo---?-o-o-o-o--ooBo--?o-o--------T--o--?o---B---oo--?----o--o-o-----X--E-----Xo-------E-B-E----oo-o---o-----oBo-XoB-o-E----Xo-f
------o-----BB-?o--o---M---BBo-o-E-B-EMo-ooo---E----o?-----o?B-oB---------o-o--ooooX------B--o---oB---o--------o------B-o---o-o---Bo---oM---oX-BB-----M--o---MoB-o-Bo?---B---M-o--o?BoB-o-B-----o-oooo-f
Mo-oBE--------o--MX-----X--X-----B-----o-oBB---B----------o-oBB--?---B?-E--?B-oo--?----------------MoBoo-------o---?B-o-BBBM?-----ooo--B--BX---------?----oo-oBo?-?-X--B-----------BBo----Bo-ooM---X---f
m-oB-BB?B-B----M----oX-oo-o-BBX-oXo-B?oBB-B-Bo-BXB-?---oB-XB?----B--EX-BB?-----o?-X-B-B-BoBX------BBB----BB-----oo-X-----B-B--BBo-B-BB?-XT-BB--?--X-oXB-o-B-BM-B------BB----BB----o-BX-o-M-BoX-o---oB--X
XoXX-BXXX-X-XB-X-o--XXoXXXX-XX---TXX--XXX-X-EBT-X-XXXX-XX-XoXX-XX-X?-XXBX-??XX-XBEX-XoX---XXXXoXo-XX--XXM-XXXX-XXXX-BXoo-X---BBoXEoXXXXXoX-XB-X-oXXXBX--XBE?-XXoBXXXoXX-X-BXBoX--XX-XX--XXX-X--oX?-oBXXX
