------BBX-o-B--oBX-B-oXXX--XBX---X-o--oT--XX-B-o--X--B--o-X-o-oX-------o--X--XX-----------Xoo-X--X--oXB-oX---B-X-Bo--o-o----oB-o-B-X-----X---X-B-oB--o----oE---B---o-----o-X-o--XXB|--X-------XXXBX-o--?
X-B-----X-?---o----X--B----oo-oB-X-----X-X-----X------M---------B--X----------ooo--o-------oo-B----oo---Mo-o--X----o---X--B--o----o------X---oo-|-BE---o---B----------------o-oo-B-XX---|------B---o---o
X-o--o--X-X-o--X---X--o-----o--B-X----o-------?--o----o-------o-X--X--------?---M---------o?--B--X--B----o----X-------o---ooX-o---o------E---oX----Bo--M--o------B-------------B-E-oM-o-X-o---BX-?-----o
XoBo------o-X---------?--?-o?|------o-------B----Xo--X----M----M-----o--------o--------B-MoX---?-X-M----o--oo----?-----o--MXo------o-X--XM-----o-?X------------o-B---o------o----M-?E-E---o---oB-ooXo--X
T-----------XB-----------o--B------o-oo?-o-----o--T--X--o-X--T-B----X-B---------Eo-o---X-B-B---X-E-B--Mo-------o----------o----E----Xo--B|oX--o--XX-o-------?--------B-------E---o-|X-Mo-XM---?--XXB---|
?-o--------o-M-----------M---------o---B-B--B-----X----------X---oo-o-o-----Boo-M-----------XMBX-X----o--------o-X--o------M-X-?|?--XB---XXB-o----o--To-o-o-o--------X--|----M-----XX----B--oo-E-XX----X
--o-X-?----?-X-------o--o-?-----B--o-o------T-o---E------------X-B---------?o---?-----o-----XoX-------B--XoE---?--------o--o-o--XX-|-------E-E---o-o-XB---o------o-------|---o--------E---oo-?-?E-o---?o
?---E-X---?X------------o-o----oo-----------X----oX--B-oo---o--X-X---o-----o-----B-------oX-o-o----------X-X-o------o-o--o-o-B---oBX---------?----------X-X------MB|-X---o---o--|----oX---MoB---M-X---Xv
M-ooM-o---E------o-B------B-o--BM-E---------o-oB-----o--B-B-o-------oo-----------XMB----o-E---T-EB---?--------------B------o?Bo--?B----o--M---B-----------X-------oX-X-------o--X---B--B---oooBo-----X--
--oX--oX--Bo------?-X-----o-----XoB----o-------X---o------o-------------B--o--X---BX-M--?-X---XoXX---BMTM--?B-------o-------oo---BX------EX--oB-o---------oo-----oM--o--------o-----o--B--B-B?B?XoX--X-T
o-----oT---B--oo----Eo------o----------o---B------------o-o---------B---X--o----o-BBM------o------M-E-oXBM-Xoo-----o-?--o-----oB---------MB--XX-BooMo--o---B-Xo---B--o--------B-o-E-------B---o-X----o-o
o------X--B--------?XXo-----o-o------o--T--B-----B-oo-oo--B--X-----Xo-----o-------BX-----------o--o---M--X-E--------oB--E-----?o---X-o---E---BX-B?-E--o--oB--X----B-o----M------M-?-o--E--|-oo----X----X
To---X----o-------?X---o----X---E---XM--X--B-o-----oBo-------X---MX----o-o----------------o-E-E---o----E---B--E-------?oBo-??-BX---B-----X-?---ooX-M-----oX------o--oo--------X----o---X-----o---oBoo-M|
o--XXB---X---Mo---Bo-M-o----EX--B--XE-oB--oB?---------X--B--o---MBX--EBB---M----Xo-o--X-X---B-?XoX?----?------BX---X--XMB-|BX-----o---o---M---XB-X---o--X?--oE----X?-B--o-o--oo----B-o-X--M---Xo--X---oE
m-XoooTE|ooo-X-E--oE-EoXT-?-XXT-BX-E?-|B||ETo-----X|ET---|-BMoEMBoEB-M|-oToEEBE|o-EMo?B|-TB--E-BoBX?o||T|-|B?BB|?-EX--T-XE|EEET|-o?X|--o-oo-o-X--XE?TBE-o---BB-TooE|XB-TXoM-o-|-X|B---X|T-E-|-E|-XEMTMTB
XXXXXXXXXXXXXXXXXXXX-XXXXXX-XXXEXXXXXXXXXXXXXXXXXXXXXXXXXXXXXXXXXXXXXXXXXXXXXXXXXXXXXXXXXXXXXXXXXXXXXXXXXXXXXXXXXXXXXXXXXXXXXXXXXXXXXXXoXX-XXXXXXXXXXXXXXXXXXXXXXXXXXXXXXXXXXXXXXXXXXXXXX-XXXXXXXXXXXXXX
