EB----X?---o-----B--X----oB----B-o-BX---o-o------BB--XoX-----------B------o-o----B--Bo---X--oE-X-o---XB------X-------oo--------X--X--o---------oo-XoX--B------XXo---XB---B--oXXo---B-----------Xo---X-oo
|------o---------------------B-----------o----o-------oo--------------o------oo--o---BB------B---o------o---E--------------------X-----------------------------------o----o--o---------o---------o--o--E
M-o--------Xoo---------------o---------o---------o--o------------o-----o----------o---X-Eo------o-----oX----B--o---------E--------o?o-o-----------------------------o-----B---o---o----oo----o------B--T
---------------o-oo--------------oB-oB-----------oo----oo-?----------------------oX-----B----------------o---------oo----M--------oo--X----oo---o--o------------o-----o---------------------------------
X----o-----o------X-----X---X-oo--o--X--o-------o------Xoo---?-o---------------B-----------------?-----o------------------ooo-----M---B------|---------X------------------------------B-----oo-o-------T
B-------------o---------B---X-------------X--o---o-------X--------------------------------------o----o-----oo--o-o------o-X------------o---o-----------oo---o-o---E-------------------B---o------------E
-----o--------o---------o-o-B----o-----o--o----X-o--o----o--------B--------o----o--o----X-------B----o----B----X------------oo---o--o-----o--o--------------E-----?o---o-o----?o----------------?---o---
B----------o--X---------------------------o--o-----------o--------oo----oo---o------o---B-------o--------oo-o------o----------E---o---o---?------------o--X-X---------------------------M------o-o--T-Xv
B-X----------------------o-----------?o---B---------------------o-B-----o---------------------oo-----o-o----o------o----E---X------------------o--B-----o-o-X--o---------X--------------B----o--oMo-Xoo|
E-----o--T---X--o------X-------------B-----o-o-o---------o----o--o-----------------o-----------o-------B-o---------o-------oB---------o--oo-------o----oX--------E----X------o--------------------B-Bo-|
B--------X--oX-oM------BE--------------o----o-o---o----oo---------oo----X-----o---o----------------B----?----o-----B---------------o---o-----M----o------------o-B---Mo----------Bo-----------o-----o--?
----o-----o--o-----o----XB-----o----------?----o-------X------o-------------o-------B------o------oXo---o-----o------------------------X-----o-----o--B----oo------o-oM------oX--X----X-E--------------|
T------------------------B-----o----------X--o-----------oX-oo----B-------o-B-------B----------o--X-------B---X-o---oX-------E----------------o-BEX-o------------X----E-------X---X---B----------o-----T
M----B-----o-----o---?----o-ooX----o--o-EB---Bo------oB-----X----Bo-E--B----o-----EB---X-----o------o-oX-oB---o-?-XB-o-------X------o-----o------Bo---o---oo--o--------o-?-Xo-----oX--X-B----B-o-----o-B
m----T--?MBoT-Bo-BBB|BX-?--TE|B?-E-T-|oo?ooEX-E--B---To-T---X-XMTXXB--XXXTE--B?-ooBTTB-||-|-MX--EB-ToB?ooXoXo---o?T---o|-BoTo-B?---oEB|BB--||-----XXBE-|---?E--Boo?--?--BXXXTX|-X--Boo--|-?-MX--oT--X|-?
XXoXXXXXXXXXXXXXXXXXXXXXXXXXXXXXXXXXXXXXXXXXXXXXXXXXXXXXX-X-X-XXXXXXXXXXXXXXXXXXXXXXXX-XXXX-XXXXXXXXXXXXXXXXXXX-XXXoXXXXXXXXXXXXXXXXXXXXXXXXXXX-XXXEXXXXXXXXXXXXXXXXXXXXXXXXXXX-o--XXXXXXXXXXXXXXXXXXXXX
