o-Bo-B-----X---o-----ooooXo--B----oB---o--B----------B-X--o---B---X-o-B-X--o-oX--B--------X--o----o-X---BB---oo------o------B--E----XXBB--XB---------o-X--BB--X--B--B--EEo--o--o?----X-BX-----ooB-BX-X-E
B-o-----B---------X--?-------oM-o----o------X-------o------------o----------o-T--------?--X-o-----o-----------X-------------X--X-o-X-----o-B----------B-------Xoo------X-B------------------o------Xo--M
--o-o---E---o-----XM-B-o------o-------------X--------------o--o------B--------X--------X--o-------------o----o------B-----o-oX-ooo---------X---ooo-oo-B-------Bo?-----------------------o----B--------oo
?---Xo--M-o---o----X--B-----oB--------o-----------B----o------X-----oB-------B------------o--------B---o-B--o-------o-----o-Bo---?o--M-----o--?------o----------E--X------o-o--X--------B--o-----------E
?---o---------o--o-o--o--------B-o----X-o--------oB----B-----------X----X----B------oB------o-M-o--o--------M-?--o-o-----o--o----?---X---o--o-B-------o---------X--X-----oB-------o--------X-o----B-oo-X
o-------o-----Bo------o--oo----?----Bo-o---o-o----o---------------oX----B--?|B--------------?---?o---?----o---------o----------------E-oX-----BX-o--oMo----X--o-B-o----o------oo?Xo---B----o-B----o----E
oX----B---X-----o----------oo-------B--X---oB------------o--Mo--o--X---------o----o-o-----o-BB-------o----M-o---------?M---o---------B--o------oo----X-----XB------?---ooo----Bo-X----o----oBB-o--o?---E
oo----oo?oo--------oo--oM--X--------o--X-o-BB-----?-o-------B---o---o-------o---o-----X--------oo--------o------------Bo-----------o-----Xo-----o-o---o--o-BX------XEo---------?------o---o-B----ooB---v
E-----X---E-----o-----o-oo--?oo---------Xo--o-o--oo------o-----X--o--------o----------o--------oo---oM-----o---------------------oB-----oX-------o-----------------MM----------o----o-----oo-----------M
|------o----o---------X--X--B-o-------o-oXX---X-o---------?Eo--oBXE-------o-?-------------------X-o--X----E-o----o----X-o------Bo-o-------E--oB-------------------o-------oX----------E-------X-------?E
|-?--XoE------?o--o--------o-oo-o---o-------o--o----------Bo----XoM-oo------o------X---------o------o-----B---o-------o------M----o--B-E--B--oB----------BMX------B---o---X---o------------o--X-------o-
M----o?-------o------------o--------?----Bo---------------B---E-B---?B---B---B-------------o-----B-------B--o---X------Xo----X-------B-X--o--B-----oB---oooX---BoB--oM----------o-----M---------------?o
|---o-B-------Boo-------------------o--TXX----o---B-oo---o-------o-------B-----o--B-o---?--Bo----X-B--o--Bo-o---oo-oo--oX---?E---------o--o----oo--X----B------oo----oX-----o---M----EB-------X-o----B-B
M--BX------o?X-X-Eo--oo--o----------XX-o-X-----B--B-X--oX---------------oB----M--Boo----o-XoM--|-X-B-----B-----------------BoB?-oo--Boo---------?--o---o-XXBo-X---o---B---Xo---o-----M------o-T----o-o-M
m-XXX--T--T|T|XT|XoXEB-B-MTE-XXEMB-?|EEX-XE-oETT|-To-o--Xo-BEMoEB-EoEE-X?B-BET|BMToM?X|XB|oEBo|X|o-XoMo-Xo|MTTXTooBo|--X--M|--X---?TT|BX|EEMoXoE-XToTTBE-oBoE|E-BE-B--BBTBB--X-X-E--XTX|o-E-|-X??METB-XT
XXXXXXXXXXXXXXXXXXXXXXXXXXXXXXXXXXXXXXXXXXX-XXXXXXXXXX-XXXXXXXXXXXXXXXXXXXXXXXXXXXXXXXXXXXXXXXXXXXXXXXXXXXXXXXXXXXXXXXXXXXXXXXXXXXXXXXXXXXXXXXXXXXXXXXXXXXXXXXXXXX-XXXXXXXXX-XXXXXXXXXXXX-XXXXXXXXXXXXXX
