o--o---o---------BoX-------B--X-B---X-X--B--------B----o-B-?----oB--B------o--BBoB---o-B---E----TB-o--EB------oooB-----------o-B-X---B---o--BX-BB-X--B--Bo--X-o------------X------oB-XX--XX-----------?o
?oo---X---B------B-----o---o----B----oo-E-----------X---------o--XM-o-?-oo---o--X----?---M-?----?-----?B-T-----??o--o--------T---B-M----------o--o--MX---M-?-o----o-o----E---------B--o|---o--B-------?T
XX------------------------BB----X----oT-M---M-------B-B--oX---B---XoBoB--X------B--o--------o-----B----B-X------B-----B----o-XB--B-X----------M-----X-o--o-o------?---B--X--?o-----B---X-o----B-----X-EB
MXE----o--o----o-------------?--B-----X---B-B---------Xo-----------o----o--------o-?-----o--------X-B------------o---------E--B--o--------------o-M--------o--o-o-Xo--B--T-MB------o-o--E----o---o---o|X
B-------o-??-------B---------X--------------X---------X--------o-?-----------o-----------Xo-o-----X?E-----------------------------------|----o-B?-o-----?--Mo--E--X------X-B-------o-T-oX------------MBo
X---------oXo-o---EE-E------------B-------o--------BB---o-------o--o----------------X-----------?B-BB-----------------o-o-o-----B?---------oo--BX---TX-oB--X---X--B----------o---M---X-?--------E--o-XB?
oB--------oo--B---BM--?-------oo---oo-----o-----o-------o---------------o----BB-----o---XT------XX------?--X-o--------M-Xo------o-------------oo----Xo-----o------M---E----------B-X---o--------M----B|M
?o----X-o---------o-o-B------------X-BX---B-----M--o---------X----?----oE----Bo-------X--X--Xo-----B--o-B---o-----|--o---?---------Boo--------X--B--o-------------X---X------oo----B--?B-----?-E---E--Xv
Eo----B-oX----------?--------------B-XX--------o--MoE---T-B--XB---------?----o-------o--E---------o--oM-----o-----X-oB|o--------T--B----------o-o--------o---------oo------------E----B------B-?---?--??
?X----X--B----------o---o---o?----o------Eoo------T-M-o-X-o--E-----------M---?---o----B-B-E-----------o--o--------o?o-X----E---X---o------o---B--o-----ooo---B--M--X--o----o---o-B------------B---X----M
E--------------------o-|X--MMo-----X-----BX--oo---X---o-----oX--o-oX?o---o--------------B-?--o-----------X--------o-BoB----X-B-B----o----------o-o--?--B-----B--B----oo-----Booo----------o---B---o---B|
oB----o--o-----------B-X-----B-o---o--|--oB-------B---------X-?---oB-Xo---o-------BX--E------XXo----X-o--B--------X-X--------B----B-----------X--?--E---o--M----Bo----------o------------o---------o--X|
-X--?oo----X-------B---o-----------?------B-o-o?--o-----------Bo--MB---------Bo---BB--?--EE---o----------o---------o-----------B--o-?o--?-B---B--B-XME-o---X-o-oM---o----o---------?--------------Xo-oTo
o---oo---XoB-------o---o-X----B------------o---?B--B---------X---E-o-M--M---------------o?X---Mo------?o--B-X----------X--X---XX--o--oo-o-o----M-?-XBBB----Eo--Boo------------------oo-o--o------B-B--ET
m-E--XET-oX-BT?E--XE-T---BT?--T-MTM|-TE-E?oo--BX--XEo-T---B-XEE---X-EB-BT---E|-------X--TXET?M--|---M--TT-?-|-oMoXXT-ooB--TMXBMooE-|-T?ET|----M|BXM--oo-T--?EEEE--T|-B-----?--XM--?X?B-?-Eo--M--BE-EXEX?
XXXXXXXXXXXXXXXXXXXXXXXXXXXXXXXXXXXXXXXXXXXXXXXX-XXXXXXXXXXXXXXXXXXXXXXXXXXXXXXXXXXXXXXXXXXXXXXXXXXXXXXXXXX-XXXXXXXXXXXXXXXXXXXXXXXXXXXXXXXXXXXXXXXXXXXXXXXXXXXXXXXXXXXXXXXXXXXXXXXXXXXXXXX-XXXXXXXXXXXX
