Mo-XoB---E--o-----B----E---o-o-oB------oXo--o--o-o--E-------o-o-Xo-----o---T--o-o---------o-o----E------------------oo--------oXXE-o----BX--o-o----o--------X-X-o----o--XX---o----oooo---o-X----E----BoM
--o-o--oBB-------o-----B--o----o---------------o---oB------Xo---o------o--ooX-o--o-------------o-B--------oo---Bo--oo?-o-o-M----oB-oBo-Bo----o------o-XB-o-M----------o---o-oX-B---------BM---?-B---o--M
--o--o--o-oB------M--------o-------------E---?oo--X--------o--o--------oo-B-----o--B-EBM-oB----E-BB------o---?B---------|---M-o--Eo-o---M--o---o-??Bo----B-o--o----------o--o-o---oo---Eo-----?--B---?o?
BX---------o--??BM---------oo-o--------oEB-B----o-o--?--o-o--?--o-B-o-o-?o-----?--XB-B-X---E-BB?X-----B-oo-X-X--o---oB-o----o----B--B----oX-oB---o-----?---Eo-----M-o--o---------------BoX-------oT?--X?
-----o---o--oB-------B-Mo--------E--o--?B?-oM--oBBoE-BMo-BoBB----ooMB----XB---------o--o-B-B-Bo-o-o--Bo----X------Xo-B-oo--?--o---o-oB?-|----E---o??-o--o---------------------oo|-oB----------oBo-----oX
oB---oo-------E-?----B-B--------BB----M--X-o-o--B-oB---B--o--?--o--X-o---o---oE---oE---o------B---o--B-------oX-EoE-oooBo-o-?--oBB-?--oXo?o--BB--?-B--oBM-o--o--o--oo-------?-?B---EX--B---oBo-o---oE-BB
EBX-o---ooB--E?M-oo----BM---------o--o-B?oB---o-X?--Boo---M--------o--B---E--oB----BB------B-------X-------E-B--B-BB-oBB-oB-Bo----o-B---oBoM-X-o---o------oo-----oo-o-o-M---o--X---B---oo-o--oo--o--B--o
X--o-B---o---B-o--oooo?-oM--o---ooB-o---oo---BM------B-?X-B?o-o----B-Bo-?-B---o---oB-EB----B---o--BEBo-o---B-----BE-Bo--oo-----o----------oE-B--BB-BM------B-?-?o-----------oX-B--o---o---Bo-B---BX----v
---?-X-----o---------B-----oooo--Bo-X----o--?--o-o--MX--o-------Bo?--B-------M-X-----BB-E--o--BoB-oB----o-o------BB----o------Eo-----E----oB-o--o---X--ooT--?-?oBB--X-o-o--Eo--o-M-?Xo-----oB----------f
E-o-o--B---oBo----o--o---B?o-B--o-o-----------o-Mo-oB--oMo-o-o---B-o-oX----M--Eo---?----Bo-B------o------o--?------BX---------B------B?---?---?----o----o--o-oBX----o--o-----B?---?-oo---X--E?B----T---f
Xo-----o-----E------oB---o---Bo---X------------Mo--o-?-o--?---Mo-----o-----oo-B?o---o-M-B-----o----B--oB---------------o-o?-o------o---o------o-?--Bo---o-M---B------T--oo----B----o--o-BB?BB--o-------f
|--B--?-----oB-T---o-----oB--o--BB------B-M---?B----Xo-----o---E---o--------oo---M----o-ooBo--?o---oo-o-------Eo-B--o--oX---B-o-------?-o--o---oo-o-X?-----To---?-EB---------------X-o---o--B-?-X?---o-f
|ooo---oB?o-oB-??--X--o--oo?B----X--o-Bo------B---E-E---oo-----B-----------o-----------------oX-o-B--------o--B--B--MB-o----Eoo----ooo-ooB--o---o----------M-Bo---BBo-oBX-----------Bo--o---o-BB-o-----f
E-oB----o----B--o---------oBE---?B-----BB-oE--XoBEB-B-o?------BB-Boo-----oo-o-o----------BB-Xo--Xo-----------B-----o-----o--B--B--o-----oo---o---------------B----Xo-M--o--B-Bo----oBo--o-----B----BB--f
m---BXX-o-------oo-----?X--oB-o-B--oE---o-oB|-----o-----B?----X--BB--B-X-B--B--BXM-?MB|oBBBB---XB-Xo-Mo-?BX?X-EBE-X---Xo--M----oo-B---B-o-BBBB-?B|--oT--o------Bo-B--o------XBoB-BXB-X-o-X-BoBo-B-BBoB?X
XooXBTXXXXX-BB--B-X-?XBXXX-XXTXXoXBBXB-MX?-o---oX?XEBB-oXXXXXX-X--B--X-X|XX-|X-BX--Xo-X-XXXXXX-XX-XTX--X-XBXBXXXX-BX-E-XXXB--o--X-XXX-B-XEXXBXXXXX-BXXXXo-XXMXXXoB-oX-oXXBXo-XXX-B--XX-|oBXo---XoXX-Xo-X
