MXoBoE-o-o-o---------o------o-----o---------o-oo------o---oo---E-B--oBoB----E-----------------oo-E-Eo----------BoEX--Bo----BB------o---------------X--------Xo-B-oE-------XB-o------Xo--o----X-X--o----M
-X-E-B---X----oE--o-B------Bo----?-----o--o-o----T------o--o---Bo--------?--B?-----o-o-o------o--B-?--BoMoM--T---B-----o----Bo-B-----o---oEM---o---E----oo------B?BX------o--EoX-oB-----oB----B-o--oo--M
-B-B-o?Mo---E--BB-ooB-oo------o---------o----------?-----o---BB------o-------EB-B----oo--o-----oM-T----------BB---o--o-M?---o--oM?B-MoX---?---B?BM----o-oo--B-B-E---B-----?BBB--Eo-------o----B------o-?
B--o--BBoB--B---Eo---o-?B---------o----|---o-oB----------ooX--ooE-oBo------o--B?o?-B--XX---E------o-?oX----E------------o--o---BX-ooB-------EX-B-o-----Bo--oBMo-BB--o-Bo---o--?-BB-----oE---o---XBBMXBB?
-ooXX-?Bo--o----B---BoX--o--------o---MXoo-M-XB-------o----XB---BoooB-o-o--B--B--------XB--B--o--o??---X?--Bo-Bo-o------B?o-----B-BX--M-----B------oo---o?-BB---ooo----------oB-o-o-X---B-B-oo---B--oooX
oB---o--o--X-oX-B-----o-BoMo---B-ooBBo--X---o--o---Bo--?-----oo-oXBX-----M--?-------E-X-----o----B-XB-B-oo--o-o-E---oo------?---o----E-?----B-B------o---B-o---E--?-B--oB--o--o-B---o-B--oo---B?--o|o--B
EXoo-o-----o-----------o-o--MB?B-o-BB--B---ooX-----X---o-----o---?Xo------M--BBM--oo--o-B-----o--o?oB-XoXBo-B---B-----BB--o--oB-X----B----o--EE-oo--o---------?B--o-X-----?--o--EB---TB-o---o--B--?Xo--o
X--oo-o-------EoB--------o-o-----o-oooBB---o-oM------------oo-X---oBM--ooo---o--X-B-M-B--?-o----------BBBoBo-----o--o----B-X-oo--o---------o-BB------------o----------Xoo---o---Boo-----o---o-------E--v
----E--------oB------o---------Bo----oo---?----o----o-B-----o?o-?oB-o-oBX----B-oB-oB-M-----B--o-B--------o-o----o-o-oo-B-o-X---ooo-?-o--M-----o-oo-M---------X----------oX-M-o--EBX-------o-B---oo--B?-f
E-BoBooo----B------EE?--MM---o---M----B---o-------oo--o-----------o---o-o---E----o------oo----ooB--M?oo-oE-o--o--oXB--XB-------XX---XoB-oBoB---BB---B-o------o-oo-----?Bo-------B------o-B-B-----M-?---f
XB----Bo--o---Xo---BB--B-o---Bo-o--o---o-o-BX---oB---?------ooo-??BBo-B-----BBB---------oo--MB-BoB--BBBB-B---?B------o---B--X--o-----X---o-XM------BoBo--o--------ooBoo---BBo--o-?-----o-o-oX-o-ooB-?--f
|-------------oB--EBBo--------ooB---o?X-----------Boo-------BB---o---?---?-------M--o-Eo-----------?o-oB--?o--B--o-----E-B-Bo-Xo---oo--o------------BX--ooo--Bo?-B----B------XoME--------o-B---o---ooE-f
|Bo------?-M--E--oBB---------oBEB-M---oo--oB----o-B--?-o-o-------?-o--?--B-M----o----oB---oB---oo--EX---------Xoo-----BBoE---B-M--o----B-oB------E-oo---------oBX-o--ooMB-o-----Bo---o------o---?-o-oB-f
E--o--o--B-B----o----o--o---X-oBo-X---o-------B-o------oBBo-oo----oX-BoB---oX----?oo------BBE------Bo-o---------o-o--?---B---o---Bo-----ooB---o--B-Xo?X---o--BBo------o-X----?--------o--?o-o?---?-----f
m-?----oX-BoMo?-M-E??B--oBBo---o-BB-BBoB-Xo-XoXo-X---o----BB-----B---BBE------X-?--XE?--oooXM|---o-X-B--oB-Xo?BX-X--BBoB--XBXB?o?BBX-B--BBo-E|----BBooo---X-XooBM?B-M-BX-----B?-BBBoBX-o?Bo-o--o-BB-Xo-X
XMoX-Xo-XXXXXXX-XMX|-XXXXXX-BXT--XXXX--X-XoXB-XXXX-XXX-BXXXXTX-X-X--X-XXX-?XXo--X-X-XXX-XXXXXX-XXXXXXXXX--X-XXXXXX-B-oBXXXBXX-XoXXXX-XoooXBXB|BBXXBXBXXXXoXo-XEX-X-XoXX-X-XX-X--XToXXXo-XXXXXX-XBXXT---X
