T--X------oo-oo----------o---o--B-X-o--B-------X--XB-B--XX--oB-E----o-------o----BX--XooXo--o-oB-B---X-----B---BB--------BX-B-B-X----BB-XB-----o-----B-oo---X-X-X---oXBB-oBo--B----B-XXEo---------X----E
M----oE------o---o-Bo-oo---X----------------o---------o--------?----X---o------------o--------X--o---------------------------------oX-oo-----------------------B-o-------o-o--B-M------M----o--o-X-----?
B-----------M--o---o-Bo----o---o----o-X---X----B----------o-E-----o--------B--o---oo-M------X-----o-----B-o-------------------------B-o--o---o-----------------o---------?-B----Bo----o--------MoXXo---X
Mo----------X--------X---------B----B-o---oB---------o-----oBX--E----------X-------o--------X-o--X----o-o---?----o?o------------o----o--o--------------o--X--B--o-------B-X-?-o-X-?---o---------B-o----X
M--------------------E-------oo-X---X-o----B--?---M-------o--o-oM--------o------------X-?---oo-------o--?---B----Bo---o------B-M-o------?-E------?-----oo-o----E-------oo-X-oo----B-o----------o-------?
|o--o-------E----ooB-X--o-B-----o--o-------XoX---------B--o----------o-----X----------X-----------o------------Bo------------X-X--------o?X-|----o---o-o------o?-----------o---oE---B-o----o----X-----o?
o-oo--------X------o-o---------o-------T---X-------o---o-------------o-o---o----o--------o--o----------------B--XX-X--MB-----B-X-o----------X--o-X---?--o------------------B--X-X--?------------o--o---T
---X----B?---------o-------o-----------XM--o-----oo------------o----------------o-----------------o-------X--X---o-X--BX-o---E---X------------B---X-----?o---------------X-o--B-X----B------o---o---X--v
B--B-----B---M----o-------o-Xo---o------X--X----------o--------B------oB-------X-----------o----o---o-----o----o-o--M--------B----E--B-o---oo-o---o-o---X-B-B-----o------Bo-B-o------o------M-o--o--X---
|oX-o-o-o----X----B------?--E--B---o-----o----o---o-----------oB------B-----o--oo-----------|--o------oo------EB----B--------oo---X--X---o-------o?--o----E-o---------------M----B--o-----B------X--o--?
E-Bo---------X----------oo--Xo-o---X------X------?------------------B--?X----------------oX-X-----oo----------ooB-------------?o-------------o---o----B---B----o-o-o----?---X--B-----M--o-XB--o--B-----o
?-B-------X--------o----XX--o--E----o-o---X--------------o----o-----o--Bo------------o---oB-B-o-o-----oo------?-----o----oE?--B--o-----------?--------o----------o-oo--B-----o-oX------oB--X-----oo-X--X
o---------o--o-------------B--o-----------B----o---o----------E-B--X---o----------B--------oo---E---E-oX--B---B-----X-M-o-BB--X---------?B---Bo-----------------o--------oo-B-o-o-----------------XoX--T
M-----X-o-----------------oB--B---------X-o-o-X-------X-X-o-B-B-o----M-o---oo----oo--?--BB----X-M---B----MX---B--B---?o-------X------M--BB---o--o----------oX---?-o---------X-X--B-Bo-X-----Boo--?-o--XB
m--B-BT-M|-M--E-EBo-?-BBE-|-?TE?Xo-E-XB-|oB|ET|-XBToTX|-|-TBXBBoX|?|-X-E--MM-B-??XX-o|X--EoXT-oTB--B---|?XT-|?X||o?-T|-B-XoET-|M-BXEETXBXXBX?-XBB-----XE-oT--BB-T--TE-E?-?oXTo|oEB|BTTTETBMEo|T-B||X-|-T
XXXXXXXXXXXXXXXXXXX-XXXXXXXXXXXXXXXXXXXXXXXXXXXXXXXXXXXXXXXXXXXXXXXXXXXXXXXXXXXXXXXXXXXXXXXXXXXXXXXXXXXXX-XXXXXXXXXXXXXXXXXXXXXXXXXXXXXXXXXXXXXXXXXoXXXXXXXXXXXXXXXXXXXXXXXXXXXXXXXXXXXXXXXXXXXXXXXXXX-X
