MB---?X----?-o?B-----X--o--o--o--o--------B-oo-o-X-X--o---BX-o-Eo-oB--oX-E-T-E--o-o-o---o--X-------o-oE-o--------o------o---oo-XBo-o-o-----oo--------oBo--o----o--oo-o-o-o------o--X-B--------ooo---o--M
--??-o----------o---------o--BoE---o-Booo--oEoo----oB---oB-o--oBoB--oX---BB-?B--?--o-?-----ooB------?-B---oB-Eo---o---EoBo-oo--o-B---o---Bo-------B?X-B-o--M------BB-B------oE-|---o--oB--------oo--o--M
----oM---X--o---o-ooEX--------TBMB---o--?---B-X--BXo--o--o------------?---Boo-------Moo--T----M----o--o--B--oBB?B---o-Boo--E--o-oo?--------oB-----BEo----------?-?oo-Xo-o-?--B----o-B---o-o-o?--------|?
B------o-Bo?----??-oB-B--------Bo---o--oXo-o----?---?---o--o----?o-XB-Xo-?----o---?-X?-o--Eo---oo--M---?oo---o-----?B----oBB-----B--------B-----o--B-----X-o-o?BB---o-------------o?-----B------oo----X?
---o----oXoo--o----o--B--ooo--BB-----o-o---M--o---------oo-Mooo--XBXB-----MM-----o---oo---o----?-Eo---E--X----o-oXo--o-o-----?oX-XoB--M---o--oooXB--o-?-ooB-o-------o--oX---M--o---Xo----B-o-?----XB--oX
o-o-----B----------B--X--oBBoBooo-----------------oBo------BBEo-----------E---B--E-MB--B--?------BX---BX--oo--o----??Boo---oo-?-----M-B-oB-oo-----o---BBXB-o---o?--------o---?o-------oB?-?-X-?-MX-oE--B
E-B--oXBB------o---XBo---o----E-X----M---M?--oMB-o-ooo--B----Bo------?ooB-B---B--Bo-Bo-oB-----Bo--Bo------?-----o-oo---o----o---o-----B-B-oB---------ooXE--B-M---oB--o------o--oo??-BBXX----B-oBo-BoB--o
X--------B------BoX-----Xo----B-o------------o-o----------------M-o-----oo-?-EX-o------X-oo--o-Bo--B--BM-X?----?---B-----M-o-XM---o--o-------B---------oB-------o-------oo--XB--Bo-BE---?---oX----o----v
--oo-?-o------Eo--X-o---Bo-----Mo-o-oo--Bo---o--oB--?--o------?X-B?----------B-?-oMo--o--o--?-M----o-Mo--o-B-X-----E-?-?--?--o--oo---o-----E-o--?o-B-o-o-ooo-B------o---o----X--B---Bo-oB-------Bo-----f
EEo----?----o-Bo--BM---------EB----XX--B---oE---oX-o-o-oM--M-o-o-o-----o?M---BXX-E--o--oBoo------oo-ooXX--?o-B-|-B-B---BoX--o-?-X-Booo?---BB------BBo--oB----Xo------o?----?E--oo------B-----?----oo-o-f
XBXB-X-o----E-oB-----o-o--o--BX-o------o---BBM--o------E-----Bo-MB--B-------BBBE-B--------oo-oM---B-o-o------o-o----------?--?--o---------ooM-BB-B---------o-o---oXB-?-o----B-----o?------------o----E-f
|----XX-Eo--Bo?X--o--o--E-B--o--o---?--B--oo-------M-oo??------X---BB----------B---o-oo-o-o--o-----o--?-oB-oo-------------BBB----oBoo--o--o------oBXo-BB---BEB-MoB-E?---------EXo-?--X-ooB-o---o-Bo--B-f
|----o--X-XBB--B-?-MMo--BEBX---oo---o-?oo-----o---E-o--o--B-o--oXB-------?-M----oo----o-o-?------o----o------oB-MBE-o-B--o----B-oBoM---o-oB--------B---oo---Boo---XBo-X------oB--oo-oEoo?----B?-B--o?--f
E--ooXoo----BX--B----B---B--Bo-oB-----Bo---BE-Bo-B--B-----o-----o-oX--ooM--X-----o-----BB----o-----------XXEX--oBB----o--BX-o-BB---E------X-E--------?BB--X-B-------ooo--o---B-o-B---B--o---?---oB-oB--f
m-?-B-BBB-B-BXM-Bo-MX---B--ooBoo-o--B--B----B-Bo-B?---oX-?B-o?---oB---E--?---------oo---?B-----------o---BoX-?X-BX-XBM-oB-TX---B---BXX--BX-o-----oBXM---o--X-XooB------TBM---B?X-E-----Eo---o--o-|ooX-oX
XoB--TXX--o-XBo-B-XXXX--XXX-XXXX-X-XBX-XXBX-Bo-XB|XXoX--XEBB|X-XX--XX-X|XXEXoX-oXXX-X-o-X-XX--Xoo--XXXX-BXB--XXBXoBo-X--X-XXoXB-M-X-XXX-XXX-o-X-XoXT---oXXBo-XBXX-----XX-o--XX--XB-M-XXBX-XTX-XXBXXXBo-X
