ooB------o---X---XX----X------X---B--B---B-o----X-----X----------B---o---o-o-----------B-B--Eo-o------------o-----X-------o---XX---X---X-----X-----o--B-B-B-B----------X-X-X-XT--BX---X-----o-B--o----?o
?-----X---------oBX---o--o-o-----------MT-----B-----o----B-X-----o--oo------T-?---------B---X----------o-----------o--o----?B------X-o-Xo--------o-B------X?--------o-oX---X--X-------o?--------------?T
X--o---------o----To--?--------o--o----To----BX-o----------B-----X--B-------X-|---------X------oX-------------?-B--X------EEB---o--B-------M-------B-------oX---o----------------------B---o----------EB
M----M------oX-----X--X----?-----------X-B----------------X-X------------------o---B--------X-XoX-----B-------o-----------XB--B---o-----Bo-o--B-----||------o---TMT?-B-oX--------------o-|-?------X---|X
B----E------o-------?------o------?B-----X-o------------?oo-X-X-------?-------MX-----------X--B--o--?Mo-o-------o----B--------X-|-o--o--o-----o-----X-------M---XXXX-E-BX--X----B----o-o-X-|--o-------Bo
X--X-?--------------X------oB-----oX--oE---o---o----B---oo---EBM--------------XX--------------oo---ooo-B-------------B-----o--X--o---------oo------Bo-X---B---oo----BBB----o-X-XMX-------X-X---Eo-----B?
o--Bo-----o---?-----B------XX----------BX--?---X-B-------X---M-oBEoooB--------------?----o----o----o---Xo----------?----o--M----------------B-o----B--X---o----B----o----B-o?o-E-X------?--Xo--??o----|M
?-------------o--------oXTo-----------?-X---------------------oo-?---o--B-----o|---?oM-o-X--------o---oooX---------E-----------T--BoM-M-?-----?---o-o---B----------------X-o---B----o-ooBo------o-T--MXv
E----B--------X--?------XXM-oo--------X-----X-----M------o--------o--X|--X---oBX--oX-oBT---o-----BBX-----o-o-------?-M---------|--o-X-o-o-----X-B-?--|--B----------------X-X---B-------Bo---o-----X--E??
?-X--X-----Eo-XT-X----------B--B--------EoooBo-o---------o-X---------BX--o-------M-X-E|X---oE--XX--o-----------------X-----B---X-o?-B---|--------o---X--o----------------X----|o------------?-Xo----MM-M
E--o------?B---XT--------------B-o-o----Bo-BB--------o-----X-------------------X-X---XX---------B--B-B-B---o--------B---o--X--------o---X-M--B---------------o---------B-B---?X-----------?-oX----o-o-B|
o|-------M|---oXX-E-----?------Bo-o?-o--B---X-M------?----o--X--o----------o-ooB-----Bo----o---------X----E-------X-X-------------o--------o-M---o-oE-oo-----X---?----oX-----oX--------------X-X--M---X|
-X-------?-----B--B----------o-------o--o--B--oo-----B-E--B--o--------------o---------o-M-------?----B----B--------o---X-------?o-?--------------B--M--o--E-?----B---BX-o-----------B--------X-o------To
o---X----X--o------------E-----B---------o-X----EBE--B-M----------------------E--oXB----Bo-----?oo----o-oBB--------o?--o--B-EB-B--------oo-B-o-M----o-X---?-o--M-X-Bo-B-X-o---------X-----oM----------ET
m-B-o-|EB-B|-?|EX----?X-BXoo-EoB-o---XT--B--o---MBXE-T------||---B|---X-M-oXXEBT-TXX----To---MoBXo-ET-MTTo-XoX-?--X-X-||--EMBTE||---B---X-TX---|-Mo-M----Eo--EE|M-oXT---X?B-----?BE-|--o-XXX-XBTE-TEXMX?
XXXXXXXXXXXXXXXXXXXXXXXXXXXXXXXXXXXX-XXXXXXXXXXXXXXXXXXXXXXXXXXXXXXXX-XXXXXXXXXXXXXXXXXXXXoXXXXXXXXXXXXXXXXXXXXXXXXXXXXX-XXXXXXXXXXXXXXXXXXXXXXXXXXXXXXXXXXXXXXXXXXXXXXXXXXX-XXXXXXXXXXXXXXXXXXXXXXXXXXX
