--------------------------------------------------------------------------------------------------------------------------------------------------------------------------------------------------------
--------------------------------------------------------------------------------------------------------------------------------------------------------------------------------------------------------
--------------------------------------------------------------------------------------------------------------------------------------------------------------------------------------------------------
--------------------------------------------------------------------------------------------------------------------------------------------------------------------------------------------------------
--------------------------------------------------------------------------------------------------------------------------------------------------------------------------------------------------------
--------------------------------------------------------------------------------------------------------------------------------------------------------------------------------------------------------
--------------------------------------------------------------------------------------------------------------------------------------------------------------------------------------------------------
-------------------------------------------------------------------------------------------------------------------------------------------------------------------------------------------------------v
--------------------------------------------------------------------------------------------------------------------------o-----o----------------------------------------------------------------------f
----------------o------------------o--------------------------------------------o------o-----------------------------------?---------------------------------------------?BB-----o---------------??----f
----------------B------------------?--------------------------------------------BB--B---E------XX-------?------------------------------------o--o---------------B-o------X-------E---------------XX----f
---------------XTT-----------T-TT---o---T---TT------o-TT-------------o-oo------TX-----------------o---X------------------------------T-TT---?-?------o--o-----XX--XX--BB-o--------TT-------------------f
---------------o||-------TT---------T---|--B|TT--B----|-?----B||--TT-E?-------||-------TT-------------o--?E?----------------TTTT-----|-|--TTX--TT-----------------TT----X-----TT--||----------------T--f
----TT-------TT-||-------|---------||------T||TTTT----||TT--TT----||--TTTT------------X||o-|||----TT--------------------T---||||-----|-|--||---||-----------------|TTT--TT-o--||--||----------T----|---f
m---||-----------|-----------------||------|||||||-----|-|--||----||--||||-------------||--|||----||------------------------||||--||------|||--||--------------------|--||----||--||----------|----|---X
XXXXXXXXXXXXXXXXXXXXXXXXXXXXXXXXXXXXXXXXXXXXXXXXXXXXXXXXXXXXXXXXXXXXXXXXXXXXXXXXXXXXXXXXXXXXXXXXXXXXXXXXXXXXXXXXXXXXXXXXXXXXXXXXXXXXXXXXXXXXXXXXXXXXXXXXXXXXXXXXXXXXXXXXXXXXXXXXXXXXXXXXXXXXXXXXXXXXXXXX
