B-X-----oB--X------X--XX-BBBX----oB-------o-B---E----oX-X-X-X------X----X-|X---X--B--o--X-o----B--o---B-X---ooE--T-XoXBX--X-B--o---B--X--X-o----B---X---X---X------X-----X--T--o----------E--|-X----X-TE
o------o-o---------BX-------B--B---X---o--X---ooB--------------?---X----oEXM---E-------B-----X---M--E---------Mo-X-o-------?--oX-----------?----o----o------B----oo-B--o-|--X------------oX--X------o?|E
T-o--B----X--o----XBX------Xo------XB-----X-----B------------B-------X-o?------M---?---o-----Bo-BX--M-o-------------o-X----X---XX-M-B-----BB--------?Eo-----o-E-BoX-X-B--X-o-Bo-----oB---?--?-------oooo
B-X-B--------B----B----?---X-o--B---B--o----------B---------MX------MB---------o--oB----------X-X--o-----------X---?--|B------------B----?X-------?-XB--------X-XM-oE-o--X---o------?B----X-X--------?|o
E--oB--------B-o-------B--E-----X--o------o-------B---o-----o-----o-Bo--X---------?---o-------X----B-----------o------XX-o--------------|Bo-------B--B--------------?--E------------------X--T-?-?B---MB
|---Xo-B---X-----------Eo-B---------------M-o-B--?----|B----M--X--------B-----------o---B-----X--o--o---------MM-o?-------------oo------X-M---------o-E----------------o---------M----X---B--X-o-oXo--MX
o------o---o--o--------XM-B-?-o--------X------o---?o--XX--o-----------oB-B-----o--o-?-M-o---o------X------M----B-MX-------------?--o-o--B---M----T----M----------------B---------X---o-B-oB------B-B--X-
M--X-------X-o------------o-o---o----?-E----X-E---B-B-X--oo-o------B---o-ooE--M-B----TX-----B--o---o------X-B-o--o------o----------B-------Eoo---X------X-------M-o----Xo------------------M---E-o----?v
---T-----o--Eo-----X--o---------E----B-Mo---B-B-M--------?--M-----oX----B--?--B-XM---|o----------o-X---o---o----------M--o---------------?-BE----B---X--B---------B----Xo------------------o---M-M----X-
T--X---o-B--MM----To-----E--M---XoX--o---M--o-X-XB----M-------o----oX-o-o------------X----o------o-----Mo--?--------oMT---X-----------------M--B-----E---Xo---------|X--B--EX-X-----BEB---oX--M-------EM
T-?---------------X---oB-BE-X----o----E--o-BXo---E----o-----o--------o------------M-?Xo---B------M----o-?--B----o---BoX-X-o--------o--------E--X-----M---X-?----B---X------X--o------BX----B--X-XX----T-
X-o-----EX-------------X--X-----------o----o-B---M------o--------B?---------------X--XM---X-o----o----?-B-o-------------o----B------T?--o---B--------X----BB----o---------B-M----o---B----B---X--o----XE
B--E--?----X---------------oo----------?----M------?---------E---BX-o-----------------------o--X---oo-------o----------------oX---o-X---B---o---------B---o-M---X---------BEX----B-BX--o---X-----o?o--|?
X--M--X-X--B----------------o?---------X----X----M-Bo-X----------X---------X------o-o-----o------B-oM-X---------------M-------o--EB-B-------X--Bo--?--B-----B--E---o------oX-----EXo-?-B-o-X-----BX---TE
m-BoE?o-To-BTT-X?--XTEMo|-|TBBE-XX--|X---EMXTB-T----?-X-TX-X-BM--E-XT-?|E-TXBE-|E||---------?-|-EoXB--TX---E|-XME--|-E|M---M-o|?-?-|o?--|oB-B|-X-XTB-T---B--XTXXB-|?---|---o|---B?E|oET--|Too--|XXo--TB-
XXXXXXXXXXXXXXXXXXXXXXXXXXXXXXXXXXXXXXXXXXXXXXXXXXX-XXXXXXXXXXXXXXXXXXXXXXXXXXXXXXXXXXXXXXXXXXXXXXXXXXXXXXXXXXXXXXXXXXXXXXXXBXXXXXXXXXXXXXXXXXXXXXXXXXXXXXXXXXXXXXXXXXXXX-XXXXXXXXXXXXXXXXXXXXXXXXXXXXXX
