?----BB-B---BE--T-oBoTo-o-|-o---o-------o--B--o--BEBXXo----o----ooB-o----o-oX-|------X-BX-T-B--BX-o---o-oB-ooB--XXX-o--B-XB|X--oEX-------BEX----oX--B--EoB-X------E-XEBEB-Bo-EBEoXB--o--X-Bo|Xo--BoT--oE
BM-M?X-B-Xoo-???X?X-MXo-Mo-B?-XEBoBMBTo-??--M--M--X--oBoo--?-B--T--o|XBTo?-XEoX-X---Eo--B?-o-M-|XoB-oo--o-ToM-E--XoXB|-E---X-?oE?ooT-X-EoXM-|?Bo--MX-o?M--M---?---M-EX-?-oX-oB-BX--E-M--o-B-X-M-EEoBB-B|
----B-?-|B--B-BB-B--BB---M----|Booo-o|-B--oM-oEoB-TBM--|M----oM--?M|X-B-?oXX?B-MB--MX--?--M?----|-BE-B--?EX---X---X-oX?X--EB?-oM-MB|-EEM-----oXB---EX-o-XMTo--------MXoBB-Eoo-oo-M-XT--X-?ET-o--M?BB-E|X
T--ooBB---oo-o---oo-o-BMX-M-?-XXBXX--XEoMM--o-B|-X----o--E--?o-?---|-T-o---Eo-oX|M---M?---o--M-o-XBM--?o-?oE|BE-EE-|?-X|--B-oXXoBB--oX?--oX-M-T--TB?XBXM-------MM-B--B-o-oXM--XE-BB-X--XBBB-o-ME-----MXE
E|Xo--|o--X-o??ETXBM?-Boo?oB--BXX--?--?o--M?X?oX-|BMM??-oBo-E--E---XBXMTooM?-oX-XBoBB-o---X-XXo?---X-o-M--XBX-BoM??--?-|BTBBBXo-ooBo-|---?E-----X----E--T-?E?oo--MB--o--o?o--?-B-B|ET-?o-B-o-o-?B--ETEXT
?-Xo?T--oM--o-oB-o------o-Xoo-o-B---?--o----o--X--E--T-?X|?-B--?--TB--BXoM---EBM--?-Eoo-o----oMBB-oB--M--E-o-oE--XXBE-oX-|---X-oEooBBX-?MEX--BE-o?-o--Mo|BoM-oB?---EoXTTo-X-BB---oXM-MEBMB--o-EEEB-XX--B
XMoo--o--o---E-X-oMMo-B?-o---X-XBoB-BMXBM-M-BM-o--B-B--X-|-MBo?--XXo-Bo|-----Bo-B--MX-X-o|BM-oE--ME-|?X?-oTB-BBT----XBM-oX------?-o--B?-oX-X-o?-MB--o-M---?-X-EE?--MX-X|-B----?o?--oB-X-----TMBMX--EB--B
X-?--BXBoo|M-XX--EXoXoBXooMXE-o--BB-E-ETBT--X--BM---Xo--XXET-X-|MB-EoB--oT-MB-B-o-EEB--X-XBBToX-o-BB-Xo--E--ooo-?---oXX|M-?------o-o?-EBToBoMEB-XBoX---XB--oX|M?-E?o|?-|-|--oo-Mo-BB-TB-?oX-XoE---oM-X-v
?EX---XX-|X---BE-B----oBXMXBM-?BXX-o?-?-XX-EXEMBX?B?-?---EBXBM-|--?BBo-E?-MB-E-o--MMB-BooBXB--X-?---oB?M-B---M-----BBB---T|--o|---ToBEBBXBT-BBBX-XX--o-BX-MM-||-oBBo--X--X--??-XX-BB-X--XBB---BM-EoE---?
X?-M----?--BBEBX--oT-M--XBXB----oB----B-oXM?BX----T-oT-o-XX----|M-o---?X-?BE-XM-MB-|-?TB---BB-oB-B-?X-X|----T-?o--B----MM---EMX?-?X?-Bo--BXo------E?-MMo-o--B||-B-XX--TBB--o-BoXBB-XB-T---Bo--|-oMMBM?-E
--o-o?M------XB-Xo-XMoo--------|M--EM------Xo-M-X-XM---MM--E-o-X-EM-MBo----M-o------o-|-MM-------X-oB-o--o?-X-BMB--XBMBoBo-oB-ooM-----?o?--?T|--X|MX?-XBXX-X-X---?--X------BBBEB-T-B-?X--BB-oM|-?|--o--o
|TB---XoE-E-ooB??oM---oX?--MBM-XXE-B---?o-o-?--o-To-?---E|-B-----X----XM-M?E-M?E-|--oo|---EX-o??oX-MX|M--X-M-M-E-o-o-EB---BEB--BX-EXoE-X-X--XX----XB-E-XB-TMX--??-o---?T--?-B-MX-X-B-----X-XX-XB--T--oX?
o|X-E---X-XoM-EE-?oM-?E---oo--?-X?XB?-BE--?B---MoXX-o-T-X|--BoEE--XTX-o|T-B-MTo?-X------MX?o--o----XB-|-T-?B-X-B|--?XXo--MoM-oM-TEB|TMo-?-MT-ooX-M-B-MXX-M---B------M--X?--o-M--?o----o--X-oB-B----Xo-|M
T--oM--oBM---oMXo-M-BBX?M--X--X-E----EB?--E----X-EB-?--XoXE?--MX-TTX-Bo--B-EBX?o?-oB-Mo-oX-B?-E-?XBoT----?B---|---o---B-M----?--X?B------M-X-MXo---Xo--EBBoX--Eo----oEoETB-Xo-B|-oM--T-?E-M----B--X-TMXM
m-?|TMEBoToBME-XT?X?BTE|XTE-o-ooM|TBX?E-|BMEMBT??BB-o??|?|M-oT--oX|-BEXoo--?BXoT-E|XTE|XXB?X-EMoB-ToX-MEoT-|XM|M?o?|TM--|XEooT-BBBXMEMoTE--TBX-XB|M?oT-XoX?--TM?oEooXEBM|-oXBo-XE-|-|XB|?B|o?|o-X-oM|-|T
XXXXXXXXXXXXXXXXXXXXXXXXXXXXXXXXXXXXXXXXXXXXXXXXXXXXXXXXXXXXXXXXXXXXXXXXXXXXXXXXXXXXXXXXXXXXXXXXXXXXXXXXXXXXXXXXXXXXXXXXXXXXXXXXXXXXXXXXXXXXXXXXXXXXXXXXXXXXXXXXXXXXXXXXXXXXXXXXXXXXXXXXXXXXXXX-XXXXXXXX
