EoX---o-------o--X---o-oo----o--ooX-----oo-o------------B-o-o-o--oo-X--------B-o--o-o---B-?---o--oo------o-----o----o--Bo-----------E-------oBo-o---o--B----o-------XX---o---B-EB----o------oo--o--X--BE
?-o--B--?Mo------X--------------BXoo-o-?---E?-----?-----oB-----oo---o---o-BXBB----o-B----------oX----oBoBBX--Bo--Bo-B?-Eoo-----o---BB----------o---o-----B----o--?--------o-----o-o------?---BBo-------B
?-X--o??oB-?Xo---B-B??-B------o-B-B----o--oB--oX----B-o--------oo---o-o--oX--oo----o----o------B?---o-------------o-BB---?-M?--------o-----o--o-?---o---XB---------o-o----BM---MoBoM--?o-o?-----o-o?o--E
oMoX------o-o--B-----o-E---?-o-----o-o--Eo-----o---BBo--oBoo--X-o--o---?BoBB-o--o---o----oX---o--o----oo--BooBoo--------o--X----oM---o-------o--oo----o--B----E--Xo-Eo------------o-o--oE------o--oB?-o?
|-o-??-----o-BoXM--E-B-B?ooo--o-o---o---B--EB-EB----------o---oo--Eo------BXo-o-M------------E--------------B--ooM---B?oX--oB-------o-oB--o--B--EBB-oo-E------B---oBB-T------o--o---o---B--M--------o---
X---o-------oB---oXBo----o?------oXo-----oEB--B---o-o-o?-Too-?--M-B---o----------o--E-o------B---o--?E------oX-------X--B---E-?--?-XB---?-XX-B-BB----ooB-o--oo----EX---------o---o---MoE---BMB----E-oEoE
X---o----o-oo--o---X--BM---BXBo----B---BooBoBoo---X-------o------oX-o------o-Bo----oBo--B---ooo-?o---B-B-------ooo-B-----o-B?oBXo---o---o------M-o-Eo---o--X--M---Bo-E-o--EB-B-----?---Bo---------B----|
|--BB--------BoB-----Mo-o-----E-o---oo-oo--------X-o-----oo----o-o----oo|M------o---Bo--E--ooB-BBo--o--o--------o--o---------o-o-o-o--B-B--------B-B----o----BX--E-----o-BB----o-B-B--o-oM------o----?-v
To-XBX--o--oM-E--oE---o?-o?-?oBB-E---o?-?--oB-o--o-o--B-----o?oBBB-oo--B-------------o--B?-?-BoBo--?---o--MX-------Mo-oo--o------Bo--?oo-------?-o------o------o---BXMoo--ooM----|-B------o------o--Xo-f
X-o----M-?--BXB-MMBM-M---B-------B----BoB--E--?X----o-o------------Xo--E-o--B-o-o-o---oXoBB------X-o-oMo---o-------o--B-o-oM----oo-?---o-ooX-----o--oE--B--oooo-?M--------E?----??-----B--B---X-?--X---f
E-B-?X---oo---B---X---o---?---o---o--oX-oo-BB--oo---o-----M----oo----?-B---XBB---oo?-o----------XB----B-o-----o--o-BooB--BMo---o-Xo-----TXB-E----?o-oB---o-------B--------BoB-X-------M--------oo---??-f
MB--B--?----------o--o--oBoX-Bo---o-BEX--oo------Xo-o--E-----Eoo-E---B--Xo?--oB--o-------o-----MX-B--ooX-X?o-----EBX--oo---B-----------E----BoX-oB--B-o-----o-o--B----o--------o--------MBM---B?B-o-o--f
B--B----ME----X--o--E-M----B-----ooooB--oo----------o--B----oB--oB---o-?-------oo------------E-BEo-E--o-o-X--ooo--XBB-oo---o-BoMoo-o--oX-------BB--o---------MoB------------M-B-------o---B-----oE---o-f
---B---oEB-----oB---B-----BB?-oB-----oo-----------o--B-o---------o----oB----oo-o---X---XoX-BEB|-B--B-o-B---o|-B---o--------MBoB-----Booo-B?------o-----o-----Booo-?----Bo-o-oXo----ooo-o-oX--oooXBM----f
m--X-XXXBEX?----BB--B---B--BB?--?B-----T--o-B---BB?--o--MMBB|X--oBB--BBo---Bo---?------BT---BBX?o-oB---X-Bo-oo-oo-B-------?BBBB-oBooXB|--EX-o---BBoXMoBB--BBo-----Bo---B-o---X--B-B-B-----X------BB-o-oX
Xo-X--XTXXX-BoX?B-XoXXB-B-X-XXXXXXMXo-oEXXX-XBXX-XXoXo--X-XXXXMX-oB-XXXB-oXB-X-BX-XXBXXXXX--XX|XX-XXXoXB-XooX-X-|---B-BBXM-BXX-X-oo--X|o-Xo?-X?-XXXoBXoXXBB-XXX-BXBX-o-XXXoX-TX-XXXXX-XXXBX|--XXBXoXXX-X
