--------------------------------------------------------------------------------------------------------------------------------------------------------------------------------------------------------
--------------------------------------------------------------------------------------------------------------------------------------------------------------------------------------------------------
--------------------------------------------------------------------------------------------------------------------------------------------------------------------------------------------------------
--------------------------------------------------------------------------------------------------------------------------------------------------------------------------------------------------------
--------------------------------------------------------------------------------------------------------------------------------------------------------------------------------------------------------
--------------------------------------------------------------------------------------------------------------------------------------------------------------------------------------------------------
--------------------------------------------------------------------------------------------------------------------------------------------------------------------------------------------------------
-------------------------------------------------------------------------------------------------------------------------------------------------------------------------------------------------------v
--------------------------------------------------------------------o------------------------------oo-------------o------------------------------------------------------------------------o-o---------f
---------------------------------------------------------------------?------------------o--o------?--------------?--?-----------------------------------------------------------------------BE---------f
----------------oo------------XX-X-----------------------------------------------------E------------X------o---------------------o----------------o------------------------o----------?-----XXX--------f
-------TT-X---?---------o--oo------------------TT------------------------------o-X------------------B---X----------------------X-----------------T---------------?--T---TT-------o----------TTT--------f
-------||------X--------E----TT---XXX-----TT---||--------B---------------TT---------o----------TT---T--------------------?-TT----------TT--------||?-------------XX-|T--||--------B----TT---|-TT----|--f
-------||------?-------------|TT-TT-------||---||----------TT----------XX--|-XX----------------||---||-------------------||------------||-----------------------|----TT-||----------TT-||XX---||-------f
m------||--------------------|||-||------------||------------------------||-----||-------------||--||--------------------||------------||----------------------------||-||----------||-||-----||-------X
XXXXXXXXXXXXXXXXXXXXXXXXXXXXXXXXXXXXXXXXXXXXXXXXXXXXXXXXXXXXXXXXXXXXXXXXXXXXXXXXXXXXXXXXXXXXXXXXXXXXXXXXXXXXXXXXXXXXXXXXXXXXXXXXXXXXXXXXXXXXXXXXXXXXXXXXXXXXXXXXXXXXXXXXXXXXXXXXXXXXXXXXXXXXXXXXXXXXXXXX
