?X---BX----------B--X-----B----Boo----B---o-----ooXX-Bo-------X--XX--------B--------B--X-o-o-Eo-X-B---B----o---------Xo-X-----oo-oX-Bo-Bo------o--X--o-B------XX----oB---B-Bo-X-X-oB---X-------BoB-----?
---o----------o-----o----X-----o------o--o-----o-o------------------------------o-----B----X-BX-------o----o---------o-----------------X---o--------?-------?-BX----------o--oo------------o--o--o-----B
------------oo----o--M---B---o---------o-------X-o---o-------M---o-----o--------B-----X---------oo-o--o-o------o-----o-------------------------o---oX-------X--o----o------o--------o--o---o-----------M
E-----------------------------------------o----X--o-o-Xo-----B-----o-----o-----oo-------o-------?-----o-B-------T--o---o--------o--oo------oo-E-o--o--oM-------------o-----------M---------------------M
|--------------o----------------------------------MX--B-----o--o--o-------?-------------------------B--oo--E--B-o------o--M-o----------o--------B------X----o--------X--------------------B-----T-o--o-E
E----------------------X------o--------------------o--o----o--------------X--o--o--------------o----BXo----B--B---------o-X------X-oo------------------o----o------------?--X-------------o----o------oo
-----o-------o---oo------o--------------------------oo--o-----------o------o------o?----------o------------B--XX--------------------o----------------o------------o-X----oo?o------------o------?---o--B
X------o----o--------------o------o-------o--o---?-o------oX------------------o-----------------o-------T---X--X---o--o---o-------o--Xo---o-----------------------o-o------X--X----B----M----o---o--T--v
X-----o-B-------X---o---------------------Boo-o--o?oo------o----o--M-------------E---X--------oXX-o-o--XXo--oB--------------X-------------X-----o-B-----X----o-------------------o-o----B------o--o-X--|
B-----o-B--Xo---o---------------o--------o------X-B-------------o--X-------------M-o-X------B--o-------o-----o---o----------B---------------M---o-B-------B-------------o-----E-------oo--o?--------Bo-T
|------------o-------o------------------------o-T-M---B---------o----------oo-o------------?B-------------o--o-o---B---------o----o---------X--------o----o-------------X-----M------------o--B---X-o--X
|---o--o------M-o--------B------------o--o-----oX-----X----o--E-------------o---o---B-X--------o--------o-----|----o?----o-o---?-X------o---------o---------o-------------------E-------------Boo------|
M--oB---------X-X--------B----o----o---------o-----o-----oo-o-o-------------Bo--?o--B-B---------------oB--B---X-o-M-o----------oo-------------o--EX-----------------------o--o-----o-o--------o--------E
E----B----------B---X-------ooX-M-----o-E--o-B----E---------X-M--B--o--B-------?-X------o--------o----oX--B--X--------------o-------o-X-o--------Bo-M-o---o--Xo-?---B--o---------------------------|---|
m-o|-T|---Xo-|Bo-T?oBTo-o?E-E---TE--?EXo?Eo-T--XoXBB-XT-T|-E|BXBTB--o--BX-EoMB?-oo--T--|TT--B---EB-X-Bo|o-|-|ET-B?EE--o|-BoM--X-----ET|-BT|BT-X-----BE-|oM-?EE-BEoM-X---o-EBTo---|XXoo-ooX--o--MXT-|X--B
XXXXXXXXXXXX-XXXXXXXXXXXXXXXX-XXXXX-XXXXXXBXXXXXXXXXXXXXXXXXXXXXXXXXXXXXXXXXXXXXXXXXXXoXXXXXXXXXXXXXoXXXXXX-XXXXXXXXXXXXXXXXXXXXXXXXXXX-XXXXX-XXXXXEXXXXXXXXXXXXXXXXXXX-XXXXXXXXXX-XXXXXXXXXXXXXXXXXXX-X
