|-o-----X-----o---X-X-Bo---X---B-o-o-oo---B-------X---oXX-Xo--o---o---oB-Bo---X-oo-o-X---o---o--------BBoo---X---X--B-o---X----oX---B--X-B-BX-B-B---o-X-----B-o----o---BoX-----B--X-B-----X-Bo-----B-X-|
B------E-----o-X--B---o---------X--o|---o--B-o---oo------------o-oX------o--o---------o----------------oo--B-------?----------------o---o-o------------o----oo----o-o-?--?--------o------o---oMo-o----oE
Eo-----B-------X--o----o------o-o---X------XoM-X-------------E-M--------------o-----------o-------o----oX------oo--E-------o-oo-----------M-------------------o---o-ooX--------------o--o-----XXo-----XE
-------o-o--------BX-----X-------oo-----o--B---------o-o-----X-------o---B-----o-----B-?--Bo---o--B--o------------oX---o-------------------B--o--------o---o------------o--------o---------------------X
M---------o--------o-----X-------o-----------------E--oo---------o---o---ooB---o-----------------o--oBX----o---o---X----------Eo-----------X----------B--------------BXo-----o-------o--------oo-------B
T-o-------BX-----o-B-o---------BE-------o--o-oo----X-----?Bo---o-B---X-----B---------o---o-------X---oX---------o--o--------B----o---o----oX--B--o---E-----ooo---X---BB--------?---o-B---o---EX--------M
M----------XoEo----------------XX--------X---B--o----o--oXXX----------------M----o------------------------B---?----X-------ooo--?----o-o------X--X---M-----------X-----B?------o-------o-E---?----B-o--M
|----o----o------o----------o--o---o-----Xo------o------o----|-o--o-o-------o--oo------------------o-----EB---B-?--o----o--B------------------------o-o-----X----------oo----------------B------o-X-o--v
|-------------o----o-----oX---o--------------o---------------XM--------------oo-o-----o----------------o-BB-o-oXXBo-----B------o----B---o---o-----o-B-oo----o-----------oB----o--------------??-B---X--?
Bo---------------BX---?---o-o-------------Xo-------o---oo-----o-o-------o--o------o----------------o--o-----X--B-o----------o----oB-B-----o-E-----B------o--------o------X-E-----X-o---------Boo----B--|
X----------------Eo------------o--o--------E--o--oo--o---------------M--o--X----o------o------------o----o-?---X--o----------o----o------B--X----oo--B-o----------o------------------------------------|
X----------o----oM----B-----oo----o-o--X---B-----o------------o-o----MB--o---------o--------X-----------B---o------o-----o----B-o--------B-----o-X-o------------E-B-------oo--------o------------o-----B
To-----B---o-----B-o-BoX-B--B-o?--M-o--o-----------o--o?--o--B---o---oBM----B---------------oo---o----o-X----------------?X-Boo-?----o--Booo--MX----------------B----o---o-o-----o-----------o-----o---?
?-o---Moo-------o-X--o-B-------------------------------X----BoX-X--o--X----oo----MB---------X----XB---o---X-B----------X--o---B-Xo------XX------o--------o----X-o--X-------B---------------X?X--X---B--|
m-XE-MBE|BXTEoB-B|E--o-ToTXX?|||-?oo-XoT-|-EXTo?-o-|--BXBo-||X-Bo-XM|XBXT--?EXXB?XX-T-T-|BoT-TB-ooE?-||Xo-|-|---TXoooBE|-EE-XToEE-X-----EXBE-?EBTToX-|EB-o-|-o|XBT-oT---|XB-o|T--EBBo--EXXB|oXTEEEBTXo|E
XXXXXXXXXXXXXXXXXXXXXXXXXXXXXXXXXXXXXXXXXXXXXXXXXXXXXXXXXXXXXXXXXXXXXXXXXXXXXXXXXXXXXXXXXXXXXXXXXXXXXXXXXXXXXX-XXXXXXXXXXXXXXXXXXXX-X-XXXXXXXXXXXXXXXXXXXXXXXXXXXXXXX-EXXXXXXXXXXXXXXXXXXXXXXXXXXXXXXXXX
