--------------------------------------------------------------------------------------------------------------------------------------------------------------------------------------------------------
--------------------------------------------------------------------------------------------------------------------------------------------------------------------------------------------------------
--------------------------------------------------------------------------------------------------------------------------------------------------------------------------------------------------------
--------------------------------------------------------------------------------------------------------------------------------------------------------------------------------------------------------
--------------------------------------------------------------------------------------------------------------------------------------------------------------------------------------------------------
--------------------------------------------------------------------------------------------------------------------------------------------------------------------------------------------------------
--------------------------------------------------------------------------------------------------------------------------------------------------------------------------------------------------------
-------------------------------------------------------------------------------------------------------------------------------------------------------------------------------------------------------v
-------------------------------------------oo-----------------------------------------------o---------------------------------------o--------------o-o-------------------------------------------------f
--------------------------o--o-----------------------------------------o-----B----------E-------o----------------------------------------------------------------------o-o------o----------------------f
----------o--------------B?-B-------------------------------o----------------XXXX---------------E-----------o----------------------------------------------------------?-----------------ooo-oo--------f
------T?-----TT------o-o--------o-----TT----------o-----o------------------o-------------------X------------B-----EB-?--TT------------------------------o--------T-------------------------BE----------f
------|X-----||---------B------E|----T||-------------TT----TT---------------------------------TT---------------||XX-TT--||--XXXX-----------o---------??-E--------E---B----------TT----------X--o-------f
------|T-------------X---T---TT------||TT--TT----|--XXT----||-------------TT--TT--------------||---------------|----||--||--TTTTTT------------TT----oXXXXX--------T||-----------||-?-----XX-?----------f
m--||-||----------------||---||---------||------||----|----||-------------||--||--------------||--------------------||--||----||||------------||-------------------||-----------||---------------------X
XXXXXXXXXXXXXXXXXXXXXXXXXXXXXXXXXXXXXXXXXXXXXXXXXXXXXXXXXXXXXXXXXXXXXXXXXXXXXXXXXXXXXXXXXXXXXXXXXXXXXXXXXXXXXXXXXXXXXXXXXXXXXXXXXXXXXXXXXXXXXXXXXXXXXXXXXXXXXXXXXXXXXXXXXXXXXXXXXXXXXXXXXXXXXXXXXXXXXXXX
