--B---B-B--o-----------B---Bo--X---o-o----B---o--BXX--BBBB----o---o-XBo----o----o--o--B---------o---X------oo--BB-----BB-B---oBoX--o-E-----B----X--------o---B-B---X--oBo------B----X-BXoB-X-B---X-----E
T-o--------o-o-------o---o-oB------?M-----X-X-o-------oE-X-------oX-----X--------o------o---------X----Bo-----o------T-------B--B--o-M-?-o---------o-----o------o--o--X--oX---M--o---M----o------o----o?
X---------------X--o--------X-o----XX----X--X-o--B-o|X-?o--o----EX-XM---X--------------------B----B--o-B-------?-----X-B----XX-Xo--o---X-o---B?-o-------------oo--BTo--o-oX---B--?oo-X-o-B--To---o----oT
?---o-X---------B-o---------o----o-X-----X-o-----X-?Xo-oBo-M----?--EX--------o---M?o--------o----B-----o--X-X------oM-oo--X-oo-X----------o--BB-o------o----?-MM-ooXB--ME-----B----B-----B---B--oB-EToMo
|---X-B-----------X--B-----Xo---o---o------o-------oX--oX-B-o------XB--------B----X--------E?----B--B-o---o-X-------o-XoB-o-M------B---o--------E-----XB----o?-o-o------XE---------o--------------oXXooE
|-B-----ooM--oB--X---o-----MX-o------------?-------o-o--?-XX--X--o-----X----------o-oB-----X-B---X--B-?--o-X-M--E-oo-oB-BB------?oB?X------B-------o--X-B---BX-B-o-B----XB-X---M--o---o----o---oM-EB-B-M
X---X-|-XXo---o-BX--oB---M-BX|o---o-------ME---------M-o--XX--E--XX-?--E-o------o----o-----o-X---B?-B-X----X-B--?M--o---oX------X-ooBB-----o--X--B----------BX------------oo-E-XT---------------oBX-B---
B---B-X-X-------o---oo---Xo--X?-----------XM--o-M---o-----X-oEXo--X-o--X------------o---oo-B------X-o---BB--E--BXB-oo---o-o---B-X----B-----M--E--B-M--X------XE---?-------?--B----o----BM-------o---B--v
?-------B----oo---M-B-----X----------o--ooo--o?-o-------oB--oX--------X--o----oo----------X------o----o-BXo-B--XBX--X------X-oX-|-------------X---XBo-X------BX---X----oX----XT-----o--oB-o---E-----o-o?
?E--ooBo----------X-o----oBo-----X--M-?-------------M----B----------o-o--X----o-----------XMB----------o--X--------?--o-oB-X-B-----------B--------E--X-oBM-o------------o?---XX----Bo-E---o---?-----B-X|
BX----|B---X----------X----MB----o-oEBB---M-----o---Boo-o-----o--oX---X-----o-?-o----------Xoo-o----------B--------B--o--o-o-o--Bo-o----o--------o?-Bo-XBo-B--o--EB---B--X---Bo----X-MM-B--o-TEo--o-o-o?
XBM---|o---o-------o--o----oX--M--X-MXX--Mo------o--B---------o------X------B-o-?---?--o-------E----o-----o----o---X----oX---o--BM-B----?-----o-o----o------o-X--X--T-X------ooXE--B-o--o--XXX?X--?-o--E
o-o---X------E---o-X--------X-ooB-Eo--X--Bo-------|---o--E----------------o--XB-X-----MB---oo-?M----o-?-ooB----M------M------Xo?oo--o-X---------X---o-o-----o-------Xo-o-oX--X-BBo---o--XX-EXo------?--M
E-X-?-o-|----X-----o-----oo---o---M----------------??----o--oB-----B-M---o--oX-X------XB----X-BXM-o---X--X---X---?-o--B--|-M---BX----------X-|-X-----X--M-?---o?X---X--?-oB-----BX---------M-M----X--o-E
m-|EE|M-|o|BBooMB?-oo?---TE-E-BT|-oT?E?-E-EETBX----E-oEX-|oE||?B?-Eo|BBo||?-TB-BooETT-X|M-oXTX|To||E-M-T|-XX-|MooE|-o-T|BXoEoMX-TE--?EToXoMT||-BEB|---?MT-X--o|B-oTXXXBooo-?E-EE--T|--|oB?-oXBEoT?BEE?BX
XXXXXXXXXXXXXXXXXXXXXXXXXXXXXXXXXXXXXXXXXXXXXXXXXXXXXXXXXXXXXXXXXXXXXXXXXXXXXXXXXXXXXXXXXXXXXXXXXXXXXXXXXXXXXXXXXXXXXXXXXXXXXXXXXXX-XXXXXXXXXXXXXXXXXXXXXXXXXXXXXXXXXXXXXXXXXXXXXXXXXXXXXXXXXXXXXXXXXX-X
