E-X---Bo--o--o-----o-B-o---X----XB-o---oB-----BXBX----B-BX----XX--o-B--------oB--Xo----o----o-o-o--X-----B------oXo--B-oB-X---o----o--B-oX---B----o-XBBXB--X--o-oo-oB---X-------BB-B----o-X----------o-o
o-o--o--B------------oo---------o----------B-o-o--o---------Mo----?-------o---X------o-------o-------oM-Xoo-------------o-----------o-Xo-MB----?B-M-o--------o-o---X--------o---XX-X-------o--o--?-----E
X-------BBX-------o-o-------o-B---o--o-------X------------------o------o---Eo-------BX---oo-----------X-------------Eo---------MM-?------X-----oo---o------o---o-o-X--E----------B-o--B-----------B----M
E--------oX--E----BoM------o--X------B---------E-o-o-------o---------o--o----------------Bo----o------B-------X-----M-------o--oo-X-B-o---------X-----o---o------o---o?oo-E-o-X-------o--------o--X----?
T------------Bo-----B-------o--------B--o--------X-o-o--o--------B--BB--?------o-------X------o----oo----?----XB---o--oo-X--X--?---o-o------o---X---------X---------?----oBoM-o--------o-----o-------o-B
X--------X---o------o-------B--------X--B--Mo-E-E-------o--------o-o----------o---------o----o-M------M-o--X---oB-----B--B------------?------o--------X-o------X--E-X------B---------o--?o---------B---X
B--------o-----E------------X-------|------?----X----BoB-B----M?-----------o--oB-o----------M--o------o----oo-?-XM-------------o------X---------o-----o-o------o----------o-o--------X--XX---------X---?
|-------------o------------------M--X-------o--------X-E-X--o-oo--------o---oEBo-B-----X----E-----oX-----o--M-X--B-------------X----------------o--o-XM-X-oo----o----E--oo----------B--oXX----E-----o--v
B---BT-E----------|--o-------o-B-Bo-B----o-----E-------M------B-------------MB-o-X-----o----?--oX--o-o------X-------o-o-o----E---------X-------------oB--MB---------oB-E------------o-------?-?--o-----?
BBo-BX-?---------o|----------------oo--X------oXo---ooo-------o-------o---X----X---?------B-----o---------o---o--B-----------B-----o---------o-oX-------Eo--X-o--------M----X----------o--ooX--o-------|
EoX-X-------------X-o-------------o-o--X--M-o---o---XXX------o---------o--o--------B------B-----X--B--o--o---o---Xo---o-o---------o-o--o-----o-XB-------X-E-o------?----o--oX----------?o--o-----X-B---o
T-----?--------------------o-----o-------oBoX-oE-------------X--o--------------B--------------o----B-----B-----oo--------------o---o------X--B------------M--X--?----o-oX-------B-------X-o------o---o-M
Mo-BB-o-oo-?o---?----X---o-------o------------o----------o---B----X-o----oE-X--B---X-----------BE---oX---X-------------o-------o--oE--E---o-----------E------o-----E-?----------o----o--------------?--T
?--o--------B--?--X-----E-B-----oo-------?o---B-B--??o-----X--------oM----B?B----o-oo------X-----o-E-Bo--X---|--X----E-X--o--E-o--oB-X?-X-X-o---B-----?---o------o-M-B---------E----------o---BMoo--X--M
m-ET-X?-|EX-T-BXB-B-oMMXBBEoXXXM?|-TTEB-BXXB-ToEX?BoX--EM|-X?X?-BBT??E--?-TXXo-BXM-|o-|-X?oo-|?E|B-?-B-ooBTX-XE|B--B---|XBo--X-|-oE--EE-B--o|o-M|-Eo-o-|-oMBX--B|X-|B--?oBX-BETXo|Xo--o---BE-XXooT-XT-oo
XXXXXXXXXXXXXXXXXXXXXXXXXXXXXXXXXXXXXXXXXXXXXXXXXXXXXXXXXXXXXXXXXXXXXXXXXXXXXXXXXXXX-XXXXXXXXXXXXXXXXXXXXXXXXXXXXXXXXXXXXXXX-XXXXXXXXXXXXXXXXXXXXXXXXXXXXXXXXXXXXXXXXXXXXXXXXXXXXXXXXXXX-XXXXXXXXXXXXXXX
