EXB-----oX----Xo--B|B----X-o---X-------o-------o-XX-----XoB-oo--o-----XX-XoX-BB-BXB-B-o---Xo----o----------X--o--------------Xo-o-E-oB-B------X------XXo----X--------------o------B---B---BoBBB-o---X-BE
B-------X-----B--o---------?--o-Eo-------oo-B--B----o-----X-B--M----oo--E-o----o-o--Xo-------oo-?o------o----o---------------B---------B-B-X----------B-----o----------B-----o-------o-------B---------o
E-------o---o--E---oo--X---XoB-oB-----------E---------------X--B---------------EEo-M--o----B-----Bo--o-----o------------M-o-B------------o-X|-----------o---o-------o--B-----B------------o--X---------?
X------o-------X-------X---o-o--------E-----------------o---o--------o-oBXo--M-X?X-o-----------------------B-o------o-o-o------------Bo--B--X--o----o--?---------o--B--------B----------Bo-o--------B--B
M------?---------------X-----M--?----------------o-o-o--B-o-------o-o-o--o--------------ooo-o----o----|------X----------oo-----oo----o---------B---o---B---X-----?--oo---E------------Xo-o-o----o---X--?
T-------o--------o---o-------B--o----------------X-o--o-E----------XBX--o-o------------B-X---o-----------o--B-------|---X------?oB-----o---------------------o--oX-o-----X---------Bo-o----o-?-------o-B
Bo------X-----o-B----o-------oo---o---------------------?---o-------XB----X-----o------o--------Bo-o-----o---------o--o----------Eo----o-o-B--o--?---M------oM------o-------o-----oo?------?-X-----X---B
X--o-o--Xo--B---B-----o------o---------?--o----------------X---------------------o-----B-------EX----oo--oo----B---o-o?------B---X--X-o---oXo--X?X---B-------o------X--oX----o----XX---------------B-o-v
M------Xoo--o--oo----o----------M------oBo-----------o------oo------o--M------oo----oo------------o------o-----B--X---o-------------o---oB-Xo---Xo----oooX-----o--o-----X---------o------B-------------E
o------XX---Bo---------?o-------o-------o------o-----X----o-o--B------------o--M------o-----o-o-X--------oXoX--X--o--X--o--o-o----------?oBBooo--------o---o---B--------X-------M--oo----o-------------M
---o--o-----X-----oB---o--------o-Bo---------o|o-?T----o----?--o----------------oB--------------o-------ooo-o----o------o-----?-----------o------o-----------------oo---o--oo------------B-o-o---------E
--o--X--oo---o---?oo--oXE---o------o----------X-oo-----Xoo-----o-o----------X----X-B------------X---------oo--------o-oBoo------o------------------o---o--------?--oo-----o-M-o---B--o----------BB-----o
-oB-EB--?--------o------B----oo----B--------M---B--Bo-----E-----------------B-----Xo-------o----B-------o-oB---o-B-----oX---o-----------B-o-----------------o---B--o--B---o-o--Bo--X-------------o-----?
X---?EB---B----X-?oo--Bo--o-X-oo--oBXo----E-o-oM---B-Bo----oM----oooo---Bo?----o-BX-o-----oB-X---?--oo----XB-----B-T------o-o--E-oo----EX------?--------o---M-o------Xo-----X------B---oB-------o------?
m-TBXBooTE-BT-EXEBoXTEBoBE--T|o--B|-T-ooTEX--B--X|-BoEE-X-BMBXEM-??-??--E--|B--B-EX-BX-BM?T|EB?-EEXXMTo-?-T|XX--MB-XX-oXX--B|TMB--B--oX-|BE-X-oXBB-Xo-ToX--|-XT---X-EXE|-o-BEXBoT-o-XBBoET-|?-oEo--|Eo|T
XXXXXXXXXXXXXXXXXXXXXXXXXXXXXXXXXXXXXXXXXXXXXXXXXXXXXXXXXXEXXXXXXXXXXXXXXXXXXXXXXXXXXXXXXXXXXXXXXXXXXXXBXXXXXXXXXXXXXXXXXXXXXXXXBXXXXXXXXXXXXXXXXXXXXXXXXXXXXXXXXXXXXXXXXXXXXXXXXXXXXXXXXXXXXXXXXXXXXXXX
