oo-----o---------B-X-o-E-------Bo-----------B---------------B---o-oo-----o-o--B-Too----------o-B------------o---X-X------------B-X----o-B-B--X-------o-oB--------------B-X----o---?---X-------B-------?o
?o---------E-----------?-----------E-o-----------o--o-------X---B---o------M-?--X-----------X--o------B------X--------o-------E-oBo-o---o--oE----o---X-X------------o---o-------------o---------------?T
X--o---B---?-------|--o--------o---B-?T-------X-----------o---------B-----B--B--B-----------------------M-E--X-o--------------B---o-E------MX-B------------o------o-|-B-?--------o-B--B--o---------o--EB
M--X---oB--B-BT----X--X--T------------X-------X------------o-----o---B-------------?-X-------------B----X----X------------o---B-----?---------M-----E---------------X-|------B-----B-o---?-?-------X--|X
B-oo----o----------------------?---------M----------------o----o-----X-----|---------X---------M--EB-o--o-----B-?----o----?---B-------------|o------M------M----------X--------o---o----Xo-|---o------Bo
X-----------o---o-X-------------Bo-------o---------------o---E-M|--------o-X--?----------------oo-Xo-oX-------X-o----B--------------o-----B--o--------X----X---oM--------------B------E----X---B---X--B?
o--------oB---B---X-------------o-----E-B-o--?-----------o---M-B-o-----?------B-o---------?-----X|Bo-BX--B---X--M----X--------------------------X-----X------o--B------------------|--X----E-o--------|M
?-------o-------o---o-----------------B------------o--o-----oX--------BB-----o------o---o-o-----XXoX--o--E--------------------oT----o-----------X---E------|---------------------------o---B-B-oo-----Xv
E-|-------M---o--o--?--------o--------X--?---------M-------------------------o-------o----?----------oM--?----E------------X---|?--------------------------X--------|------------E----------o---------??
?-X---X--Bo-----------|---------------B--o---o--------o---o-------------------------------------------o-------B---o-?X-----B---X--o---Mo|---------------------------X-----Xo-|---B--------X-?---o--?---M
E-----Bo-X?-----B-----X-?------B-----o---o---o----|---o-o----------?o-------------M-----------------|----B--B-------Bo-----X-----?M-o-o-X------o-----M---oB-----B---------B----B---B-M-B--B---X---o---B|
o-------XX|-----X-------B------o-----?------------X-------o-----o--T----------o---XB--------o-------X-------B---EB----------B----BB--------o---?-o---o----BE----B----------B--o----B---BB-----o-------X|
--------EM|---------------o-----------------oBo------B--TE------M--X--------E------E--o-M---B-o-?---------------X--o----o-------o-B-------BX-----B---X-o---XB---o----------B---o-------X-----oB-------To
o---o---MXXE------Bo-M----?----B-M--?--------X-------B--XB--------E----X-----------?--o-o-B---M-B------------?----------------------------o----------------Xo---o----------EB--o-------B-------X------ET
m--Eo-M--oo?-X----o--------?-E-BM|--EBET-BBTo--|--X-o-T-E---o-----XM--------X---------EB-EB---B--B|-MEMXT---o---oBX?X-----EM--X|-----XB--|----M--MT--o?B-E-|-B---oT--o-M-o-?XB-----B?BE----T|-?T|o|EXMX?
XXXXXXXXXXXXXXXXXXXXXXXXXXXXXXXXXXXXXXXXXXXXXXXXXXXXXXXXXXXXXXXXXXXXXXXXXXXXXXXXXXXXXXXXXXXXXXXXXXXXXXXXXXXMXXXXXXXXXXXXXXXXXXXXXXXXXXXXXXXXXXXXXXXXXXXXXXXXXXXXXXXXXXXXXXXXXXXXXXXXXXXXXXXXXXXXXXXXXXXX
