X----Eo-------o--X--o----|oE-------BB------------E-X-----o---o---Bo-XBo--o-------o--oo-B--------------X--o----B--E----------o---------B-o----Xoooo-o-ooo-----oo---o-------o--o-o---oo-----B-E---o---o-Bo
Moo-o?-oBB---oo----o--B-o-oBo---------o---o---oo-B-----o-B---------oo------oo---o---------o------Bo-oMB----o-----BBo-----oo-o--o-------?-Bo----Bo-------?o-o---Xo-Bo--------E-oX--B-oo--?--BBo?oo---B---
?---MEM?-oB------E--B-BoBo-----o-B-Bo-o-o-B---o----XB----o----------o-XoMB----------------?----o-B-o--------?o--o-o?--oo---oo------o------Bo-----oB-------------o---------?-?-----B-?T-o-oXE--X-oE------
?----B----BB-----B--o---oXE-----Bo-E----E-----B------E--oB---Bo--?-BEo-o---o------o----o------o---o-----------o-------E?-M-Mo---oooM------X|--E---oooTB-------------Eo-----o------o--------B----oBX|?--E
|-o------B-E-----o--XBo---B------BoBB---B---?-oo--T--BB-----o--o-BoXB-o-o---X----o---?-o-------oo-XB---o---Eo---------B----o--oooo---oXoX-----B-----o-------oo-?o--oBo--BB------BoE---?oBo----------o-B|
oB-o------BB-?B---X-oB----B------o--B-o-X------------BBB-oB---o-------oo-o--ooBo?---EX--o-o-------Eo?-oE---B-----M-oo---oE-----B---?--ooo-o---------o?B---------?--|----o-oB-M---B-BoM---o----T--oo-MX-T
TB---E---?-------XB-oo------o-o----Eo-Bo------------oo-B-o-oX-oX---Eo--o-XEXB-Bo---XB---X-----o-o------B-oo-----oB---o---B-oBoooBo--o-----ooB--?E--E-E---------BBoB----EB-?-oo--oX?o-o--o-----Xo-----o-E
T----Bo-o--------B----BM--?-oo-----B--o-Bo---o-?-----B-X------o----B-?-XX-B---X----------o-------o-------------o--------E-o--B-B---------o------?BoB-?-o---------Xo----B------o---------o-o---------o--v
oB-?--E--o--o-BoB-M----o---M----?oB-------?--o-B?BBB--|B-oX---------BXoB-?-X----Bo--oo-----M--?B-XM??-o--oXo----o-o----oB-----ooo------o--o----o------o------o---Bo---oX------o--o?------------o--oo---f
-ooX--BBo---o-BB-oX-------------oo-------?--o----B-BE--XX--X-------E----o--B--E-B-|----ooXo-o--BBooo---o-Bo-E-o-B-XB------o----B---Mo----?Bo-o--Bo--B-??-o---o--------?-----------o-?---------o?-XB--o-f
-MB----B---o-----?BoB--Bo---oo--o--o---T-----o--Xoo-B?--o--o-o-BoBBBo--oo--X--B-----oo----o-----BX-----XoXooB?-----E----ooB-----------B?oo----B--B-|B--E---o--o---oo--oB--o--M--EXo--------MXB--MX----of
-B--o-----o?----Xoo-----------B---EXoo?-E------B--?--o-X?------E-X-ooMB-B-------?--|Boo-XBoB---Mo--o-oo-oB----o---oBo--o--o-----M--oo-o--Bo--Boo--MoB--B-oX--o--------?oo--o-o--B--------M------BB-oo--f
|o--X-o--?-X-B---E--XE-----oB--?-?B----?B---o--o-E--?--Bo--o---B--oBB-o---------oBoo---o--B----oo--------o----E--o--o?Bo--BoB------------o---?-----B---o-M-o-----oX--------?o-------o-B?-----o--o?---o-f
T--Boo-o-oBo-o--EB--oB----o-X--BB-o-----XX-?--Xo-B---------o------o--B--BooBB---o--o-----Xo-o--Mo------Xo-----BoB-o----MBBX-oo-B?B-o-o-BoX-X--o-o--Xo-M-o--B?ooo---------------M---------oBX--oo-B---o-f
m--B-B?-oo---o--B----XoBB--BB--B-?--MX---o-Eo--?-X-B--o-BMXX-X-------BB-BBB-B-----X--?---EMBX--B----oX?oB-Bo--E-o--oBB--oB--B--B--BBB-o-XBBBX-oBB?--BB---M-B-X---B--oo-T-----ooXT-B-M---BB--?BoBo-B-?M-X
XXXX---XXXXoBo-?XXXoX-B|XXXX-o--BBXXBXX-XX-B--XX-XXXX-XXXX-BXXo-BXX|XX-XBB------XoXXXXX--XXXXXo-oXX-XX--B?X--XXXX--oBBX-XXBX-?XoBXX-XXBoX--X-|XBXXoX-XXX-X-X-XXXoB|-XXXXo-XBXXX-XXXBXX-XXX-XT-XXB-XX-oBX
