T-------XBX----X-X-B--oX?-B--X---X----o--B----o--B---B-oo---o-oX-X--------X--XX------------o--B--X-------X-----X-B-E-oXo-----B-o-B----------XX------X-----o----B---o--o-Xo-o-----X-----o------X--B------
E-------X-----o--------o------o--X-------X---o---------X----------------------X-oo-oo------oo-B----o-----o----X----o---X--o-oo----o----o-----o--o------o---o----------------o-oo----X--------------o---E
T----o--X-X-o--o---------------B-X---oo----------o----o----o--oX---------------o-o------------B--------------------o------o-o-o----o---------o-o-------M---------B-----o--o----B------o-------B-----o--?
?--o----o-o-X------------o-o---X--o--------------X---o--?--------o-------o----o-o------B--o---o----M-------o--------------o--------o------o----o--o--------------B--------o-----o---------o---o--oo-o--E
E-------o---Xo---o-------o-----------oo--o-----oo----X-------To-----X--------------oo--o-----------Bo----------o-o--------o---oo----X---------o-----o------------------o---------o-----o------?---X-----
B----------o--------o--------------------B----o---X--o-------X-o--o-o-o------------------B-E-M--------o----------X--o------o-X-?-?--o-------------o---------o----------o------------o--B----o--E--X----?
o---o-----o?-o--o-----o-o-?-----B----o------------E--o-----o---------------?---------oo------o--------B---o---------------o--o---o--------o------o-------ooo--o--o------------o-----------o-o--?--o---?o
?---o-X---?-------------o-o----oo-----------X-----X--B-oo---oo-------o---Boo-----B----o-----o-o-------E----X-----o-oo----o-o-----o--o-------------o-------X--------------o------|-o--o------o-------o-Xv
T--oM-o---E--o---o----o---B-o--oM--------o--o-----oo-o--B----------o------------ooM-------E-----E------X---B-----oo-B--------Bo--?o--------o--B-------------------o--XX-----oo--X-B----B-------o-------B
X-oo--o---Bo--------X-o---o-----X-------------------------o----------o--B--o-o----BX------X----oX------T----B-------o--------o----------------B-o---------oo-----XM--o-----o-----o-----o--X-----X------|
|-----o----B---o-----------------------o----------------o-o-o-----------X-----o-o--B-------o-----------X----o---o----?--o--o--o----------M---X---oo-o|-----B------B-----------------------B---o-X---o--M
?---------------o---o-------o-o---------?------o---o---o--B---------o-----o--------X-----------o----o---------------oB---------------o-------B--o--E-----o--------B-o--o--------------------ooo---X-----
Mo---X-----------------o--o-X-------o--------oo----o-oM----------oX----oo-o---o--X----------E-----o----E------------o--o-o------o-----o--M-----o-o-M-------?-----o--o---------X----o---------o---oBo----
M--X-B---X----o-o----M-oM-------B--X------o-?-o--------E---Xo----BX----B-----------o---oo---B---o-?X---?---?---Xo-----XMB------o--------?---o--------o--o----------?-o-oo-o--oo---oB-o-X-------o--X----E
m-XXo--E|EoXoX-EE-BE-BBXTX?-XXT-B--E?-|B-|E-o---oEX?oXX-T|BBToETBX-B-E|--BoEoB-|o--M-?-|--B-oE--oBXXoo|-|-|BBT----XXT-TBXEBo-?T||oo-|X-oT-o-o-E-oX-?-BE-oXooBB-TBEE|-B-oX|M-E-|TX|-E---|T|E-|BE-Eo--EM|X
XXXXXXXXXXXXXXXXXXXXXXXXXXX-XXXEXoXXXXXXXXX-XXXXXXXXXXXXXXXXXXXXXXXXXXXXXXXXXXEXXXXXXXXXXXXXXX-XEXXXXXXXXXXXXXXX-XXXXXXXXXXXXXXXXXXXXXXXXXXXXXXXXXXXXXXXXXXXXXXXXXXXXXXXXXXXXXXXXXXXXXXXXXXXXXXXXX-XXXXX
