E--------o------EX------------X------B---B------X---E----------------o---o---T---------B-B--E--o----X-------BT------------o---To-------B-----------o------------B---E------X-BXX-BX---oo-----E----X---TE
X-o-X-----------MoX---o-o--o------------X-----B-----Bo---M-------o-----------X----------B---X-o--------o-----Xo----o-M-----?B------X-o-------B----------------------B---------B----o--o------X--------XB
M----------------XTo--o-------B---o-----o---E-B-o----X---o-------------o--------------E-X--M---oX------B---oB-B------X-----EB---o--B----B------------------o--?-o-B---------B----------B--X--?--------|E
M-----o-----------X--------?--M-----------------------------X----------M---Xo--B------X-----E---X-----B--------------------?--M---------Bo-o--B-----|------o--X---B------------|----o--o-|o-----------X-
o----------Bo---?|---------o-------B---B---o-X--o---------oBX---------?X------Mo---o--------M-o--o----oB--o----------B--------X---o-----o?----o----EX------M-------X-----X---------------X----o---M---?T
E----------o-----X--o----B-o-----XoB--oE--X----------------X------?---X-------XB---B-------------------B-------o-----------------o-----------------B-----------o--oB----------oo-X----------------oX--||
----o---------?----------ooB-B---------BX----------------o-------Eo--B---X---------------o-M-------o----B--M----B------Xo---------------------o----B-----o---------------B-------X------?---o--??o----??
B---?---------E--------o-To---B---------X------------B-----------?---X---X----o|-----------X-----------E---B---BE--E-o-B--------M-B-----?-M---?---?-B---?-----X----------Xo-T-------o-o---------B----o|v
--o--B--B-----B--?--E--ooXM-o------o-|-------------------o---------------X----oX--oX---TE--------?-X---M---X---oX--?-M-?--------B---------X-----o---X|--X-o---X----------T-------------B----o---------M?
?-------|--Eo----X----o--X--B--------X-----o---o-------------------------o-------M---E|X?----o---B-o-----------T---o-X----Bo----Xo-----o--------?-B-BX--oE--o-X---E----X-X-------------X-------o-----o|o
?--oE---X-E?--------B-----------------|--o-B---T-----oo------------------?B----?-X---?X--------------B-------o----?-------E-------------o-E------------B-?---o---------Xo---??o------B--------o---o---Xo
|--B?-----M-B-o---E-T-----------o-oo-oX--------X-----?---------?------------EooB-----Bo----oo---o-X--X----E---------------X-o----------B--M--?---------o----M----?----o-----XoX------B-------?--------|-
E--------E--------B-X--------o-----B-?-----B---o----------B----B---------E-----E------o-o------------B----B----------E------E----------E-----B--------------E----E----X-o------------B-----------------|
?--------X-----------E---E---X-------------X----M---B----?o--------------B----E?-oXB----B-------X-----o--XB----------MEo-Xoo?B---------XE----o--------X---?-X----X-To---X-o------------o--oXT---------oo
m-B---|TB-B--E-E---TB??-TX---EB--o---Xo-EM---E--|----|------||-o-BE-----------B--oXX----To----o-oo-----T-|-T?--E--T-|--o-E-TBTE-X---B---X-T--B--------B---X----E-XoX|----?T-----?B?----o--?XX-BoB-T|---|
XXXXXXXXXXXXXXXXXXXXXXXXXXXXXXXXXXXXXXXXXXXXXXXXXXXXXXXXXXXXXXXX-XXXXXXXXXXXXXXXXXXXXXXXXXXXXXXXXXXXXXXXXXXXXXXXXXXXXXXXXXXXXXXXXXXXXXXXXXXX?XXXXXXXXXXXXXXXXXXX-XXXXXXXXXXXXXXXXXXXXXXXXXXXXXXXXXXXXXXX
