--X----?E-o-------XX----B-------o-EBo-----Xo-B-X-----Bo-XX---B-------?--o----B--o--BX-----o----------Bo-------X------B-?-----oBBB-B-----EB-----X------BB----o----------o-------X-o--B------o-XBo-oB-----
-o--?--?X-----o--Xo-B----------------B---oXX---------------T--T-----o---------oX----------B---oXB-------------XB--B----?---ooB-------?--X--o-------o--B--o--?----o---BX------o-B-X---------?------E-----
----ooXo-------------M--o-M--oEoo----o-o-----o----------o---o-X-oo-----o?X----X---oM-o--------MXB-o--------E--o--------------E-------B-------o--o-----------B--B-oX--Xo-B?o--?-E?--------?--------M-----
-----oE--------XTE-|oo----o---??-----o--o---------------Xo-----o---X---o-X------o--B---E----o--XX---------B?-M-oo---------o-o?--E---------------X-M-----------BB-BX---M---?-M--BX--------X--o-----o-o---
------B---------XXEXB?--?-------------?--------o-----oo-EB---o-B---o--?B-o---M--X-EB---?o---B--E---o--B---XX-B------B--X-----X--------------------X--|o-------o?----X-----o-B------T---------oo--?E-B---
---------------?--?-----X-------o-----oo-----X---B----B-MT?--?-o---?--------ME--X------oo------X---?--B--o-----X----T--o-----o-----------------------X---E--------E-o---X-o------X-X---o-----X-|-E?o----
----------E----B-----o---------M----------?-ooB--o--o----XX-------o---------XB-Bo-------M-----o--o------o----o------X--?---------o?o--M----o--------|----X--------?---X-X-o--M---X--------o------B--Eo--
----------X-----------------o--B-------o----M-B----X---oEXBo-------o------------X-----?---M----o--------M--o--?-----o----B--------E---o------E-?----X-------?--o-?B---X----o-B---B-------o--X----BM-?X-v
----oo-----------o-----o--o----X-B?--B--o---B-o--o?B----X---------X------Mo--o--------o---X----?----T---------X-----o----Xo--oB---M---B----o-X--E----oo---oMT--------------------X---oo-X---B-----X--X-f
-X----o--------o-B---------o-----Bo--B-----To--E-?----o-X--BB--o--o----E-X-----------oB---o-B-------X---------BBX---?--------?Bo----B-------B---X---B-Mo---oX-o--E------------o------oM-o---------Boo--f
-X--E-?---o-E--Mo-?-----X---o---------?----X---B-X--?-?-o--oB-?B-------X--------MX|---o-----B-------oXM-M----o-oo---X--------B--o-----X-----o-o-B--?B-------o----?----E--------o---XB-Bo-B------o-o----f
--X-?-----B-BX----BX----X--------o-B--B---M------o--o-----??-------------o-o----XXX-------------------X-B--o-B-B-o---X--o--o-o-----E--X---E-X-----------------o-----X-?-o-----------B---MB-----M--?----f
--B-------B-------Bo----B-o---B----B-X----o------M-----o??B--------oo----------?B---o---------B----------------BB----B--?-------X--X-T--o-?--------o--------M-------o----------E-----o--B-M----o--o----f
--B----B-o----------B--X-?-|--XX-o--X|-o--o---o---o-----o-X-oT-?E----o-X-------To-o----o--B----o----------o-X--------X---------B-----X---oX---B----o-M-?----E-------X-----X-E--?o?B--o----X----o?------f
m-?E---BTo?-X-BM---EB---oBX|o-To----E|-X--?|o--B?-?o---T----o|-|M---?-X|Mo--|-|X-T?---o-|XXBT--BXT--T-|M--o-Eo----X-|---M-E|T-||XB-oXE--oT-||E--EBB|MX-?-?-??Bo--E--T----EBBBXX-Eo|--E-M--oBX-M|EE-E---X
XXXXXXXXXXXXXXXXXXXXXXXXXXXXXXXXXXXXXX-XXXXXXXXXXXXXXXXXXXXXXXXXXXXXXXXXXXXXXXXXXXXXXXXXXXXXXXXXXXXXXXXXXXXXXXXXXXXXXXXXXXXXXXXXXXXXXXXXXXXXXXXXXXXXXXXXXXXXXXXXXXXXXXXXXXXXXXXXXXXXXXXXXXXXXXXXXXXXXXXX
