-BoX----ooBB-ooo-X---o--B--B--o-Bo-o-----B-oBXBX-----------oX----Bo-oB------o--B---o-o-B-----oE-XBBX-XB--XB---BX---B-----------B---B----BB-B-B---X----X-o-X-----------Bo--X-XBB-----BX------o---o------T
?--B----------oM-----X-o--------X--B--o--------------o------o-------B---o--------------E-----B?----------B-------o-----------B--oo-o---o--o-----o------oM---------o-o-----------X----------B-o---------X
|--B------o----X--o--o--------o--------o-----B---o---------------------oo-----oo----o--X-----------------o---------o----o--o-Boo----o------o-----o-----o-----------------X---o-oB--------o-o---------o-E
B-----oo--X-------------------X-----oo------oX----------------------o---------o-o-----------B-o---o------X---------------?-o------?M-o------o-o------o--------o-----o-o-BB-------------o-------------M-T
?----o-----------X----------o----X-oX-o--o-o------o--o--------o-------o--o-----B--------o--------XooEo-------------------B-oX--B--o---B-M-B----------o-Bo---X------------X--B---?---o------B-------E|--|
|-o-?----------o-oo-o-----?--------o---X-----------------B--MXo-----Bo----oo--oo---------------o-o-?--o-o-o----oX----o--o---B---o-B-----X--------------B---oo-o-o------o----o---o--o------Xo-------X---E
?-X-o--M-o------o--------BX------ooXo------o-o--o--------X--X----Eo-oM-o--B-o----Mo--B------B------Xoo-o-o------X------------o----X---o-----------oBoE---o------MX---------o-------X------XoX-o--------X
?-------o--------o----X--o---------X-------o----?---M---oX--B----X--X---------o--o?--o-----Moo----B----o--o---------o-------------B----------------XXX-X-o---o---o--------oo---------o--o--Xoo--o--o---v
|---B-----?o--?--o----o-------o-----o---o-----?-B---Bo-?-X--------------------B-----o-M---B-o--o-o-----o--------o---o-?---B-------o-----------o--------B-B------------------B--------X-o-------X-----o-?
o---oo------o-o---------------M?----?----E----o-X------oX--o--o-----o--X--------o--o--o---X---o--------?--o-o----o--X-----XB-oo----B---o------X--o---o---BM---o-o-----------o------X---------o-B--o-o--?
E---------------o-----oo---B------o-o-Xo----ooo---B--B--X-----------o--X-B--o-----X---X-o-oo--o---o-------o----oo----------X--------oo-----------X---X----oT|-B--o--------o------B-o-------o--------B--M
M------B-----------o-----o-Xoo-oo-B---oo----X-o--------oB----X-o-----o-B-B--X-----B------oo-X---o--------------B----o-------o----o------X-----------X-----BXXoX-------X---o--------Xo--o-----Xo--------E
o----o-B-----o-X-o-----------o----------------B--------------o--E------o-X-----------E---B-oXo----o-----------------X--------o------------X--o------B---X-oX-M--o-----o---B-----------o---o--XM----E----
|--o?oB-o--o--oo---X------------B------o-X----XM--------X---BX-oooX--BBT----oBB--oo---o---?E----M?XB---o-?-B----?--?--MB---X-X-----------Bo--B-o----X--?-----B-------MB-------X-|B---------Xo------?-X-|
m-?oBXE--XEM--oETM-TB?Mo?MB|-X-EoEXX|BB--oETT-ooX|E--EBXo|ooXBoEEETEX|BX-|T--TTX-|-B--X-T-oX-o-TB-XBT--BTB-TXT?oXo?Xo-TE-o-EX|T-oo--|M-TET-MXT-B---BEM-BT--EE-B-EE-BEXX|E?-oTB|X|B-o-||-oBT|--B?-|EE-|EM
XXXXXXXXXXXXXXXXXXXXXXXXXXXXXXXXXXXXXXXXXXXXXXXXXXXXXXXXXXXXXXXXXXXXXXXXXXXXXXXX?XXXXXXXXXXX-XXXXXXXXXXXXXXXXXXXXXXXXXXXXXXXXXXXXXXXXXXXXXXXXXXXX?XXXXXXXXXXXXXXXXXXXXXXXXXXXXXXXX-XXXXXXXXXXXXXXXXXXXXX
