|---------B-X-----X-X--oX--Xo--o--B--oX----BM---o-----X-XXo----E---o--X---BX----B-X--|---oo--B-X-oo---oB----oo-X------BX--B-o--B---B-Bo----o-oX-B-----B-X--X----B-B-----EX--T-o--------X-XEE------BE-XXE
X-o-?-------|----------X---XB-?-------XE------o------o---------B---X----o--B---------o-o--?----------o----?----B----o--------ooo---E--------B--------------B------B----oB---X-------------XB--o-E--B--Bo
MX----MM----X--oBE-o-------XX---o----o-M---B-?-------oo--------E----o---X-o-------------------oo-o--B----oB----X----B---------o--M-B--------o-o-----XE----------o---------------o-B----------oo-M-----E-
Mo-----XB----E--oX-?-------XB---X------------X-----E-----------B------o--------o--oo-------E--XX?B--X-----B---------|--E-----B---X--------------E---B?-----------o----o--B-oo---?-X----------------oX-MT
o-oo----o----X-------B-----XX-----oo-----------o---?---------?M--------?X----X-X--oo-o---o--?----------------------BX--X-?---B---------o-oo---?-M--o-B---B---------------o-M-----o-----------------oB-|-
X-----E-----------oo-o-X--o-E-o----M--o-----o----E------------B-------o-o----B-------o--oB--B----o----E--o-o----o--B--o--B-X----o--o----------o-B--E---o-X-----------o----o--------------------------oBX
B-o---M----o-----------X----?-----oX-------------?-oB-----------o------------X-o-----o-----------X---XB?----E------E-------B-------o-o-------oMX---X---M-----B-E----------B-o-X---------X------o---B--Bo
BT--o------X-o------o----X---X--o-----o----o---o----X-------o---o-?-o----o-EB--|B---o-----?-o--B---oo--X---MB-o----?----o------o-------------o-B-------------X-------o-----B-BX---------oE-----X------Xv
-X--o--E--oB--------oBo-X------o------------o--o---B-------o---o--B------B-XE--XB--o---------X------BX-o---o-----o-----E-------B---------o---Boo--M----o----o-----------X--X-X-----------M-o----o--o--|B
TB-----M-------------B-Bo------X--X--MX--M--E---X--------------BX----o?o-E-BB-oB--B-B--------o-------X-M-----o----------------------o?--o-----BX-oo------E----?-----X---B-------------X--X-X-------oo--B
E--T----X--X---o----o--------o--o-o--B---X--Bo------E--------?-oBo---ME----B------X-MX-Eo----o------o-o----E----o-------------o-----X---o----o-X-----oo-oX---oo-BB--X--o--M---X-------X----BX?X-o---o-X-
|-oX--E-X-To----o----o-------o--------------Xo------?---oo---X-o-?----M-----o-------oEX--------------o-----Bo-E?----------o--oo---T-----M-X--------X-----E----o-Bo---o-X--BX--B--E-------X--o-o-o-----oE
M-BB--?---XB----X---------X---B--------E-----------?--X-oX--oo-E---------------o----BMo--------o-------o---oo-M-B-------B--o--B--o----MTB-E-o------X---o-M------X--o-B----o---o--X--------------M------o
o----X---XB--------o--------o---T------X--X--E---oBB-?X--------M---o-------X------o---M------------o------------o-o---M-B--B-?o-------oX--X-X--------B------B------E----o-o-----X--o-----o-o--X------MM?
m--o-ooTBo-|oB--?--BE-EEToo?ooT-|X--|?---|EXEM----XE-Eo-X?|X|--o|E---|B-T--EB-----o-oT-BME--M-?-ET?B--XM-T|-E-B-o----?BM---B-o|?oEEBMTX-X?oBT|--E|To-T------EE---TE?-M-|---M|o--B-E|--|Boo-||EXB-?-M-T--
XXXXXXXXXXXXXXXXXXXXXXXXXXXXXXXXXXXXXXXXXXXXXXXXXXXXXXXXXXXXXXXXXXXXXXXXXXXXXXXXBXXXXXXXXXXXXXXXXXXXXXXXXXXXXXXXXXXXXXXXXXXXXXXXXXXXXXXXXXXXXXXXXXXXXXXXXXXXXXXXXXXXXXXXX-XXXX-XXXXXXXXXXXXXXXXXXXXXXXXX
