--------------------------------------------------------------------------------------------------------------------------------------------------------------------------------------------------------
--------------------------------------------------------------------------------------------------------------------------------------------------------------------------------------------------------
--------------------------------------------------------------------------------------------------------------------------------------------------------------------------------------------------------
--------------------------------------------------------------------------------------------------------------------------------------------------------------------------------------------------------
--------------------------------------------------------------------------------------------------------------------------------------------------------------------------------------------------------
--------------------------------------------------------------------------------------------------------------------------------------------------------------------------------------------------------
--------------------------------------------------------------------------------------------------------------------------------------------------------------------------------------------------------
-------------------------------------------------------------------------------------------------------------------------------------------------------------------------------------------------------v
-------------------------------------------------------o----------------------------------o--------------------o-----------------------o---------------------------------------------------------------f
-----------------------------------------------------------B-?------------------------o----------------------------?-----------------------------------------------------------------------------------f
---------------------o--------XXX----XX-----oo--------------?--------------o---------o--------------------------------X-------o-o----------------------XX------------Bo--------------------------------f
---TTTT-------o---------------TToT-o---o-------TT---------------------------B-BB----------B--T--o---------------------TT-----TT?----T------BX-----o------------------BX-B----------o-------------------f
---|-||XX--TT---------------T|||-|---BB--------||----------------------TTo-----XX--------XXXX|----TT---------------TT-||-----||XX-TT|--X---X-----|--E---|------------XXXX------------------T-----------f
-----o----------------------||||-----XXX-------||--------TT------TT----||--------------------||---||---------------||-||-----||------------||---------o-|--------||----------TT-------o---||-----------f
m--|-------||---------------||||---------------||--------||-----||-----||------------|-------||--------------------||-||-----||----------------------||-|--------||-------||||------------||-----------X
XXXXXXXXXXXXXXXXXXXXXXXXXXXXXXXXXXXXXXXXXXXXXXXXXXXXXXXXXXXXXXXXXXXXXXXXXXXXXXXXXXXXXXXXXXXXXXXXXXXXXXXXXXXXXXXXXXXXXXXXXXXXXXXXXXXXXXXXXXXXXXXXXXXXXXXXXXXXXXXXXXXXXXXXXXXXXXXXXXXXXXXXXXXXXXXXXXXXXXXX
