o--X-B-B-X--B--o--oB--XXX--o-B-----o-o--B----B-o--X--B----X-X-o---o----o-oX---X--XX------XXoo-X--X------B----B-X-B-Xoo-o-------ooB-Xo----B-X-B-X--Bo------B----B---o----BoXX-oX--XB---X-------XBXo--o--M
T-------X-----o-------B-o--o-oo--X-o-------------------o----o--------o-o------ooo--o----------B----oB----o-oo------o---X--B--o--oo-o---------oo--------o----------------------oo-B----o---------o--o-o-E
|----o--X---o----o---o-----------X-------o------------o-o-----o----------o----------------o---------B--X-o------------o---oo----B-o-----------X-------o---o------B---------o---B-----------------------M
To-o------o-X---o--------?-o--------o-------------o-------M----M-o---o--------o--------B-------?----o-E-oo-oo----------o--o--------o----------oo-?X------------ooB---------------M---------------------|
B---o-----o--------------o--------o---o--o-----o----------X--o-B-----------------o-o--oX-------X------o--------o-----X-----o--oE----X-----o--oo--XX---------?--------------------o--o--o------o--------o
B-o--o-----o----------oo-M---------o----------o---o---o----------oo--Xo------oo-M---------o-X-------o-o-----o----o-oB------oo-X?---oX----oXB----------o---o-o-----o-----o-------------------B----------E
M-o--------?oX---o---o--o-----------oo----X------o---------------B-----X---?oo--------o--o--X------------o----------o---oo-o---M---|------------------B---o------------------o----------o--o----E-o---o-
----E-X------o-----------------ooo---------------o-------------------------o------------------ooT------------o------o-o----------oBX-o---------------o----X--------|-X---o-----------o---o-oB---M-----ov
|-ooM-o----------o--------------M-------------o------o------o------o-o--o----------B----o-----T------?---------------------o--o--?B---------o-------------X--------XoX-------o-o-o--B---oo-o-o-o--------
E-oX--------------o-------------Xo------------------------------------ooB--o-------X----?-----Xo-----BM----o--------o---o---o----BX----------o------X-----Xo----o----o--------------o----------?XoX----E
|-----oT------ooo----------oo--------------B---Xo-------o-o---------Bo--X--o------BB-------o------o---oX-----o-----o-?--o-----oB---o---------X---o--o--o------o-----------------o-------------o-X------X
X------X---o----?-o---o----E--o------o--To-B-------oo--o------------o------------oBX-o---------------------E--------oB---o----?o---X------o--B---X----o---B--B----o----------o--M---o--------o---------X
E----------------------o----------------X-oB---o----B------------------B-o-----------------oE----------E---B--E-------o--o-----X-----o----------oX--------Xo---oo-o-oo-------------o?o------oo-o-o-oooME
E----B-X?------o-----M-oo------o----E---?----------------B--o---Mo--E-BB---X---o-o---------MB----X?----?------BX-?----X-B-|-X---------o-------XB-X------o---E-o--B-o---------oo----B-o-X-o------------oo
m-X--o-X|o-B|X----X--BoXTE------BE-E?--XB-E--B----X|XT-----BMoE-BBE-X-X-o-|EE|EB--EMoXB|XBT--E-B-o|BX|---?-B?B-oXEoX-BT-XT|-X--|-oTXo|-X?o-E--TB-XE-TX-X|X--BE-T-XEEXB-TXE--o-|-X-BB--XBT---MoE|-X-|TX-E
X-XXXXXXXXXXXXXXXXXX-XXBXXX-XXXXXXXXXX-XXXXXXXX-X-XXXXXXXXXXXXXXXXXXXXXXXXXXXXXXXXXXXXXXXXXXXXXXXXXXXXXXXXXXXXXXXXXXXXXXXXXXXXXXX-XXXXXoXX-XX-XXXXXXXXXXXXXXXXXXXXXXXX-XXX-XXXXXXXXXXXXXX-XXXXXXXX-XXXXX
