BX-B---|o---BXXB---X-----X-X--B--B---ooX---------T----E-B----T--BE----o------X--o-Bo-X--X|-XEo-B------X|--X----X--XB--B--------B-E-X-Xo---X-?-B-B------oT-|o--oo----B-B-B-BEX--XX----oo----|X-o--BX---BB
EBE-oB-Xo-B--B-----oM-------o?-?-B---EB----oB--X-|B-|-BM--X--X---?o?XoEBo----B----oX-B---X--Mo-o--o--oBX-o-E---------M------?-----M-o--X-------------?-?X-X?o-M--XB----BB-BM---oEo---------XX-oEo--o--EB
X-MoXX--o-B-Mo---M-oB-|B-X--T-B---T--B-----BT----X--X-B---------o--BoBB----B-------E---o-X---?-E-----oo--B-X-------oEX----X-o--E--X-?--oo-----o-----?X-B---oT-----B-o?Bo----M--oM-M-BB--?------M-?----B|
B-B-----X-B-E-o--o--XM-BBoM---Bo--Xo--------|-T-----------------B--o----o?-X---o-|-X---X-X---X-?--o--BX-X-X----X-XX-BX--o-o-MB-X--------B?o-o-?M---oo|------Xo--oB--EXX-E---o--o--X-X---o?-oE--o-oX-M-Bo
B---?-B-----?------?oo-Xo-E-B-----EB-X--oo--XoXX---o-o-|o--M----BX---B---o-----B-Xo--o-X-------o--X---|-oEX-o---MooE--E---?-TX------X---EX--?--BM---MXM------X?--X-BX---M?M--?------EEo---EM?--B--o-X--o
?oM-E-ToT?o-X-E----XBM----BBo-?-XoM--EB--B-XBXo------o-----X---oBXo--oB----o?-X?MX-BB--T--M--E-B--X---X--X--?--EXTX?o-Bo-?X-X---oM--E---M--o-----M----o-X-----BE?X-B--?--BE--BX--E--BMEB-BM-o--X--o-----
oBB-MB|-XX?-o-BMB----B---o-BX-X-E----?X---X--XM--o-----o--M--o-M--o?o------?XoXBBoEoX--X--o-oX-------------M-?-BXXX----oX--oB-o-MoXMBo--X----Eo?-Xo-o--oo-----E?E---oBo--XMooB---XM-X-XE-E---B--Eo-----?
TXB--oX?|-BT--XBE-----B--?-B----Xo-o--X-E-B--|--MB---B---XX---oBT-?B------T--MB-o|M-B----o--X--BE--o---X---o-oo--o-oo--E---B--M--?-o---X---B-?BB-BB-E?BoXo---oXoB---?Xo-X|-?XEX--EX-o--?|M-B-BX-?Xo--X-v
|------oX?oXB-B-X-----Bo-oE--------B--E-X-E--X--o-oT-----T---o--X---o---X-X-|BB-MXB|---o---MX---X--B--Mo--E---?----oM--X--E------|--o?-B---o-Mo-----BX---?-X-E-XE---B--M-X---Xo--M--B--B|o-o--?---Bo-B-T
?-oBo-o---X-BB---?----oB-MBBB----o----?-o-B--o--X--X-oo?X----M-----M---MB---X------X--oB---oo-oo----o-o--TBX-------E---X--X--MEoXXo-XX-BB-oo----o--oB------o-B--M-----BX------B--B-BE-|oXM-X---o-MToo--X
T---EBMEB--oE---oo--o-?Bo--oo---oMo---B------o--Bo--o??----------Booo-oB-----oM?M--XM-X-o--oX--XE?o?--Xo-X-E--?M?--Xo--M-?---X?BX--ooB-----B--|--B-BE-B----BXB-M-B-oX---?o-TX----BXEM-XM----?X-?B-XBM--T
Xo--BX-?o-M-B-------o?--B--Xoo--MoE---B----?-Eo?BM-B--XB--M?---o-oBM--X----Eo?--B--B--X-M---Bo--MX-BX-X---E?--BBo--------o---X----oE----E---o-X----EB-XXo---o-Bo-B-o--o?|o-X|--M-Xo?--------oEM-B--X-ooE
o------oX-oo---oB-------X--o-M---|?------?-BMM-o-B-B--XB--BX-o-o--EXX-Eo---Bo-o-X---MX---o--XoMT-XoX-oo---M-----?--E-o---------o-o-B-BE-B---BMX---??---Xo---oMo?---X---XXX-oX-MXo--------X-o-?o-----o?BT
B--Mo--oE---?-BMB-o--?---?-?---M-X-o-M-oXooXB-----o-----T---------B-X-XM----o-o--B--oXX--?--BMBX--Mo-?-B---X-----?-X------MB-B--oB----X--o--Eo---BB-M-ooX----|?XMX-X-MB--X----oo--|--B-oEB-XoEB--X-?-|BE
m-EBEEo-?B-MTTo|EEX-XB??To--T||ET|BX-oooBX-E-|?T-M-?EBM-|-TB--METBo?--XTXT--oo--M|EEXToMT-?--o|-o-B-||BoT-oEE--oX|M-X-oEEBX-|T-?XE--oM-M-?-?Xo-X-TBTEX|--o--EXET|-Bo--|TT|-B-XETTT|BoT-MB--XoB-T-E?E|X-X
XXXXXXXXXXXXXXXXXXXXXXXXXXXXXXXXXXXXXXXXXXXXBXXXXXXXXXXXXXXXXXXXXXXXXXXXXXXXXXXXXXXXXXXXXXXXXXXXXXXXXXXXXXXXXXXXXXXXXXXXXXXXXXXXXXXXXXXXXXXXXXXXXXXXXXXXXXXXXBXXXXXXXXXXXXXXXXXXXXXXXXXXXX-XXXXXXXXXXX-X
