o------o---------B-------------Bo-----X-----------X------B--B---o---B----o--|-B-T--------------E-------B--o-------X-B----------B-X------B-?--X-------o--Bo----X-|-----B--X--------oB-XX----E-|B-------?o
?oo------?---------------o-----------o-----------o-oo---------o-B---o-------X?--X------?-M-----o-----------------o-----T----------o-----T--o--E--o-B-X---X-?|---X---o----E-------ooB--o----?--B-------?T
XX--------------------o----B----X-----T-----M-----o------o----------Bo------XB--BB---|--o|---B?---?-----M-o-------------------B---o-----------M----B------ooX-B---o--BB--X--?o-----B------------o-----EB
MX-----oB-----To--|------T---E-MBB----X-------------E-------------------o--------o---X---X---XX--oX-B---X--------o--------o---B--o-o----------T------------o--X---T--B------B--------o--E-------M---E-|X
B-------o---B-----|----------?EB--------------------X----------o-------------o-T--------BB----------BB--------B--------B--M--------B-o-------oX-----------oM------X----------------o---oXo----------?-Bo
X-o-----M-?-o-----X--------X-------------------?----------------o-----?--------X--------o------oo-------------X--------X---------?---M------oo----------o--X--------B-B----------E-o-----?------------B?
o-------------B---X---?---EX-----M--------o--?-X---?-|---o------------E----|------------X-------X-------o------------------------B-----X-------------------o-o------X-E----------B-|------------------|M
?o------o-----------o-Bo--M------X-----?--B--------o-X----------------B-E--X--------o-----------------o-B------------------?M-------oo-----B--------------------------X------o-----B-----------oo-----Xv
E-----B|------------?--X-------M------X--------o--M-E---T-o--X----------?----o---?---o--M------------oM-X---------X-o--X---XB--------------B--------E--------------T-------------E--------------------??
?-----XXB-----------X----------B------B---o--o----T-M---X-o--E-----------M-------o----B-B------------Eo------B?---o-?----------XE-o-------o---------?-----------M--X-------o-|-o-B----------------o----M
E---------?----------------o-------o-o----X--o----X--Xo-o----X--o--?-----oo------------M----X-------|M-------------|B----------B??M-o-o---MM-------------o-----EB----o---------B---B--------B-----o---B|
oB----B--------------------?---o---?-?------------X--B----------o--T------o------------B----oEXo----X-o------------XX------------B----X----o-----oE--------E----B-E---o------------B---------------o--X|
-X------E------------------B--------------BXo-o---o---X-TE------M--XM-------o--o------o-M-E--Bo--------------------o-----------?--------?-B------B?-M--o---X-o-o-B?---E--------o----------T--------M-oTo
o---oM--MX---------o------?----------------o----------?-XB---M-----o----M---T?----------o-B---M--o----?-------------------X----X-----o?-o-o----T---Xo--X---Xo----o----B-------------o----?X------B----ET
m-E--oME-oo-oX?E------X--|o?--|-M--|--E--B----M|M-XEo-T---?--TB---X--B-?T---X----T-X-E--EXBE?MB-X---MEMXT-M----?oB-?-o-|--EM--X----M--B-T|----M|X--TMo?-----E-E---T|-o---o-?--XM---B?B-EMXX--?---o--XMX?
XXXXXXXXXXXXXXXXXXXXXXXXXXXXXXXXXXXXXXXXXXXXXXXXXXXXXXXXXXXXXXXXXXXXXXXXXXXXXXXXXXXXXXXXXXXXXXXXXXXXXXXXXXXXXXXXXXXXXXXXXXXXXXXXXXXXXXXXXXXXXXXXXXXXXXXXXXXXXXXXXXXXXXXXXXXXXXXXXXXXXXXXXXXXXXXXXXXXXXXX
