--------------------------------------------------------------------------------------------------------------------------------------------------------------------------------------------------------
--------------------------------------------------------------------------------------------------------------------------------------------------------------------------------------------------------
--------------------------------------------------------------------------------------------------------------------------------------------------------------------------------------------------------
--------------------------------------------------------------------------------------------------------------------------------------------------------------------------------------------------------
--------------------------------------------------------------------------------------------------------------------------------------------------------------------------------------------------------
--------------------------------------------------------------------------------------------------------------------------------------------------------------------------------------------------------
--------------------------------------------------------------------------------------------------------------------------------------------------------------------------------------------------------
-------------------------------------------------------------------------------------------------------------------------------------------------------------------------------------------------------v
---------------o---o-----------------------------------------------------------------------------------------------------------------------------------------------------------------------------------f
------------o------------------------------------------------------------------------------------------------------------------------------------o-----------------------------------------o-----------f
--------------------------BE---B--B?--------o----------o-o---------------o--oo----------------------------B-----------------------------o--------B-------------------------------E-------B?------------f
-------X-----------------------XXXXXo---T----------------------------o-oo-B?--------TT----------o----o--------------------------------------?-----------B-----XXXXXX--o-?------TT----o-----------o-----f
-------TT-------o-------------------T---|------?-------XXXX-------TT-E?---XX-XX-----||----------------------------------TT---B--------------------------X-TT-------------------||------------------T---f
---------------------------------------------X------------------||----T---TT------||-TT----|||---XXT---------T----------|---||X------------||-----------o-||T------------TT----||-------------o--T-|---f
m------||||------|-------------------------|||------------------||--------||------|-|||----||-----||---------|----------||---|----------|--||--------------|||-----------||----||----------------|-||--X
XXXXXXXXXXXXXXXXXXXXXXXXXXXXXXXXXXXXXXXXXXXXXXXXXXXXXXXXXXXXXXXXXXXXXXXXXXXXXXXXXXXXXXXXXXXXXXXXXXXXXXXXXXXXXXXXXXXXXXXXXXXXXXXXXXXXXXXXXXXXXXXXXXXXXXXXXXXXXXXXXXXXXXXXXXXXXXXXXXXXXXXXXXXXXXXXXXXXXXXX
