B----oBo-----oo-EEX-------o------E-o----o------------o-------o-----BB-oo-XEooXX---ooo-o--B--o-o-------B----oE------o--------E-------ooo-BE----o-o--X-Bo-E------E---o-E----o-o-o-BX----X-oo-o---------o-o
XB---o-oo---o--E-B-----------?-o-B--o-oX----o-?-oB-MMEB------X-B------Bo-o?-M---B---o---o--BoB--------Bo--o-BX--o----B---oo-B----BooB--o---o--BMB--o--B-B-o-?oBB-o---BB-oo---------BE-o---o---oBT-o--o--
o---o----o--o--B?-oo-----o----o-----------?---------oBo-o------BoX---o--------X?----o--Bo-------o--o---------XB-----oo-----E------o-B?ooo?---?B----B-o-M---o-B-o------------XoM--Bo-?B-o--?--oX--o-EX--T
T-------------ooBB-o------o---o---o-----E-------o?B--Boo--------o--?--?-----B?oE---BoX--?B--o--o----oo-o----o---------B----BB----M-oE--------X---------o--?-o--------XoXB-o-oBT--B-?o----------o-X-B---|
---o-M---B----B?B---B--o---B-o--------E-B------Bo|-----o-o-o--M-o--B-----o---Xo--B--?o-----------o-oo--------o------X-oE-o--B-o----oBoM|----Bo---Xo-ooo---Bo-oo-------E-BX---oE---oB--oE------oo-------M
E--XBo-oBB--?B-B--oBo--EB?----?-oB---oBE--o---Boo-?o---o---?--o--ME------------oo--oo-oM-------XBB----oo-?--Bo---B-oo-?B-Bo---EoX---BBo?--o--XM-----------o---------------oB--BE---BoM-B-----o-o-BEo---T
|-o-ooB-----B-X---B---BX-Bo-o---o-BBXBoB-o--BXBo--o---oo----o-E---B--?---o--------B-----o--Bo-o--oo-----o----?o--Eo?--------o-Bo-----oo-?-o-o----?oB----------o----B--?----B-o-B-----X-o---?---XMTB-o--|
M---X------oX?X---oMB--o-o------o--oooo-?-----B-o-oo-?o-T--?--BEB---o-o-ToBM--o--BBoo-MXoB-Booo------------o-----B-BB-oBB-----------o-oB---oXB------X-oB--Bo------o---o------B----BoB---------BB---o---v
Boo-B-------------------o----------o----o-o----o-o-X--B-o------BB?-o-oM-X-B-?-------EX--o-o-----o--oB?----?-------X-XBo-B---oBo--o-----------o------B-MB----?--------------EEoB---B-o-----o---Bo-----?-f
Too-B----o-o|-X----?-------B----EB-------------BM--o---o----------oo--oo-?--B-E-----?----BB-EE--ooE------?--?-oo--o---X----o-B--X-BoX--oo-Bo--o-----Bo--M--------o----o--o-BBoooo---Eo-----oEXo-o-E----f
|-B-------o-oEo-oE---Eo-o--o----B--o-----oB-oB--------o-----------o-o?BoEBoo--B?o-o-------oX-B---T?-o----B?----B-BXo---------ooooB------B--B-o---o--ooE---------o----B?---o--------oB-------B-B-E------f
BB----?-X-oBoB?X-B-oMBX----Eo------------------------oo--M-o-------B----B-B--oo-o----?----o---o-o----oB---oo-?-oB-o--o-E?o--------Xo-oB--?o-o----BXM--B-?--M--E?o---o---?X-o-MMo-oo----o----B-o-B--o-B-f
E-----X--?o--Bo-o-------BE-BX--o-------o---E?-?-o-----------------EX?o-----?---o-M-B------B--oXo---B-------X-B---B---B-B-oE-?o-----B-----B-----o---o?-----o---Bo-T-------oM-ooBoB-o-----oo--Bo-oBoo-oo-f
E-----Bo-oB-B----o-E-----B-o----------o-B-oM--o-XoB--------BM-T--MBX-o--oo------oooooo-----BoB------o-------o---?Eo----B-?BB--B---o----B-B---o-M------oo--X---BMo-------XB--oo--o----o--o---B-B-o-XT---f
m-?B-BBX----B-BBE--BB-?BEo--X-Mo---o-|--B-B---M--M-oEoB---Xo-BXXo-X-----?-XB---Bo--?EBo-Bo-BX-B-B-oTB----BX-----BB-oX---?B-X?o-oB--o--?X-----T---oBB--B-Bo----oB--B----oBE?--B--MXB--oBo-B--BB-Bo-BX-BoX
XXTX-XXXXBoXo-XXX-oooXXXXX?XBXXX-XXBBXo-BXoX-----BX-XXXo-XoX-oBXXX-X-XXXX-XX-X-|XXBXBX-XoXXX-XB-X?XXB-XX-XXXo-XXXoXX---X-XXXX-o-X-XBXXXBXX-XXXo-XXXXXXXXX-XXoXXXoXX-MXXX-BoXX-TXX-XX--XXXX---XX-XXXXXX-X
