--------------------------------------------------------------------------------------------------------------------------------------------------------------------------------------------------------
--------------------------------------------------------------------------------------------------------------------------------------------------------------------------------------------------------
--------------------------------------------------------------------------------------------------------------------------------------------------------------------------------------------------------
--------------------------------------------------------------------------------------------------------------------------------------------------------------------------------------------------------
--------------------------------------------------------------------------------------------------------------------------------------------------------------------------------------------------------
--------------------------------------------------------------------------------------------------------------------------------------------------------------------------------------------------------
--------------------------------------------------------------------------------------------------------------------------------------------------------------------------------------------------------
-------------------------------------------------------------------------------------------------------------------------------------------------------------------------------------------------------v
--------------------------------------------------------------------o-------------------------------o--------------------------------------------------------------------------------------o-o---------f
---------------------------------------------------------------------B---------------------o---?-----------------?--?--------?--------------------------------------------------------------BE---------f
---------------E?o------------o---------------------o------------o-----XX-----?-?--------------------------o-----XXXX--------?B--o----------------o------o----------------------------------XXX--------f
-------TT-----?XXXX--T--o--oo--B?--?-------TT--TT-------B--------E-----oo------XX----TT-------------B---X----------------TT----X---------------------------------?--T---TT-------o----------TTT--------f
-------||------X-----||||----TT------------||--||--------B-------X------ETT-------------------------T--------------------||------------TT-------------------------X-|T--||--------B----TT---|-TT----|--f
-------||------?-----|T||----|TT-TT--T---||||-||-----------TT----?---------|-XX---------------------||-------------------||------------||------------------------------XX|-----------T-||-----||-------f
m------||--------------------|||-||------||---||-----------||------------||-----||--------------|--||--------------------||------------||-----------------------------||-------------|-||---|-||-------X
XXXXXXXXXXXXXXXXXXXXXXXXXXXXXXXXXXXXXXXXXXXXXXXXXXXXXXXXXXXXXXXXXXXXXXXXXXXXXXXXXXXXXXXXXXXXXXXXXXXXXXXXXXXXXXXXXXXXXXXXXXXXXXXXXXXXXXXXXXXXXXXXXXXXXXXXXXXXXXXXXXXXXXXXXXXXXXXXXXXXXXXXXXXXXXXXXXXXXXXX
