?-oB-B--o---o--o-----X--BX---BBXX----XX-------B-oX--------B-------------o-B---XB-B-X--B-?---X--B---XBB-To------B--------B--?-B-o----X----------B-o------BX-X-o---o---X--Bo--o---ooX---B---B-----Bo--B-BX
|----T----o----o-X-----o-B------------o-------------B----o---o---T-------------M-----oB--oM------------X-------o---X---o---------------B-----------o-----o-B---|------E--M---------------o-------o----o|
o---MX-o-----X----------E-----B-o--X-------------|--Xo-----------X------------oo---o------B---o--o-X------BB--o----o---B-X---o----------o------------------o-o--o----oX--------------oo-----o--o------X|
M---oo-------o----o-----M---M-oo---o--o---X------Xo--oM---------------o-------Bo-XM?-B----------o--oo--B--XX-------oE----X------------o------o-X--o-------X------o-o--X---------ooo--oo----XX-----------
M-o----------o-----------------E------o---oo---------Xo-o-o---o--o------o----X-X-XB--|--------X----o---B-----X--o---M--o-----X--o-----o--------B--oE--B---o----o-----o--M-------?-M---------------o--B-B
----------B-----Bo----------o--B--o---o-------Bo--X--oX-o-B-o-X--------oB------o-X-o-X-------XB--------------oo--------B-----o-----o-----------o--B?--B-----------o-----o---o--oo-----B-------------oB--
M--------o----o-----B---------Bo------X--o-----E--B-?---X-B------o----?-----------------o----o--o--------o-------------------B--B-o---oo-o-----o------B----B------------X------o--------oo------X---oX-o
o------------------oo---------XB-o-o--o--------?o-X-o---X-----o-------B--B----o---o-----?-----------oo---X----------o-o-o--o----o---o--o-B-------o--o-o----o-------------o----E---o------X------X-o-Xo-v
?--o------o--------o-X-B------o---------o---------B-----X----o-----------X---X-------X-----o----o--o---B----------------------o----------Bo------X----X----M----X-------------X---oo-E-----------o-----B
|----oo-B-M-o-B----B-o-B----------X---------------------------o-----ooM------X---X---B-----------------B--------o---o----o--------o----o-Bo--X---o--------------o--?-o--Bo--------X--M-o---------M-----X
E--?-o-o---------E------o--------o-----o----B---B------B--------o-o---B--------o-o--------------o---o--------o-oM---oE-----T-X--------o-Bo--------o-------B----oM-oB----X----o--o-X---o?-------Bo-Moo-??
o--o-------?|----Boo-------B---XooB--E-B------------oX-----EE--------X----------------o-o-----o-oo---------o----o--o-?--o--X-B----o---X-X-M--?----o-------o---o-oo?-----X---o-----------o-----X--oBB---M
?o-M---B---o-------o---?o-X---ooXoXB-----------------o------X-------Xo---------------?o-X------B?--o-o--------?----BoB-------------o-oB--ME--B?----------o-----?--EB------o--------B----o-----o--?----oo
?-?oMT-B-----B-o-----o-X--o----ooXX----o----?-o--X-?---B--X-B------EX----------XB--o-oo-X------X--?----------|X----oX---XB---------Bo----o---oX--XM-?o----o-o-----?oo-o-o---B-o----X-?-------X---------X
m-E-E|MB-T-M|oo|o-E-E--E--o|--|?-|T-XBBEX|oXB-TBEXMoBTXX-X|--EE-X-BMBEBoX-B-oE-Bo-o-B-?XT-|B----|-X-|-XoEE|T||TBMo|TX--E|TE-XM-||-ETo-B-E-E-B-B-EXooE|XT-|-|---TME--B--BE-X-|-oX--oo-XB|XB-XE|-o----M-MX
XXXXXXXXXXXXXXXXXoXXXX-XXXXXXXXXXXXBXXXXXXXXXXXXXXXXXXXXXXXXXXXXXXXXXXXXXXXXXXXXXXXXXXXXXXXXXXXXXXXXXXXXXXXXXXXXXXXXXXXXXXXXXXXXXXXXXXXXXXXXXXXXXXXXXXXXXXXXXXXXXXX-XXXXXXXXXXXXXXXXXXXXXXXXXXXXXBXXXXXX
