|-----o-oo--------------------oB-B-----------X--X----B--oo--o----X-----B---o-o--X--BX-------X-B---X----X--B-----o----oo--B---o-BB-----------B-X--B------B-------XX-o---B-----X-X--o-oB------X--B-X-X-BBE
T----------o----o--o--o-------X----------o----------------ooX---oo-----------------oo----------o------------o--------o-o--o-----o------o-o-------------------o--------------oo-o----oB---------o--oo---B
?--o-o-------------o---------o--oo-o--o---------------o---------------oo---------------------o-------o------o--------oo-------o--o--o-o-------o----------?--o----o----------o--B-------B--o------------?
To--oo-oX-----oo----------o----------------o------------o---o----------------------o-----o---------o------------oo---------o-------o--o-----------------o------o--------o--------------B--------------oM
X----o--oo----------------------o-o-------------o------------------o--------------------------------o---o-------B?-oo--?--------------------o-o-o-------------------o----------o----o----------o------oX
E-------o---------------o---o-----o-----o--------?o--------oo-X-------o----------o---o-----o------------------------------------o-----oo--o-------o---------o-X---o---o--------------------------o--o--E
|-o------------------o-----------------------o-o------oo--o---o----o--------------------------o-----------o-------------o----B--oo-------------oo-----------o-o-----oo--o---oo--o-o-------------------oE
E-oo-------------------?-----------------------------------------o-----o-o--------o---------------o-----------------oo-----o-o----o---------Bo--o------X---------------------------------------o-o--|--v
?--o-X------o------o----------o-ooo-----------o------------------o-------oo--E------------o-------------X---o--o-------X-----------------oX----------o---------o-o-----o----------------o--o------o----T
B-o------o-----o-o--------------B-----oo--o-------o------o----o--B------M--------o-----------------------------o-------o------o----------------------o-----o-----------------------------o-------o--o--|
?----o----o-o-oo----------o---------------o----------o-----o-----o-----------o-o------------------------------?--------------------o------------Bo--o--o-----------o---o---o------------------o--------T
E---------------------------------------o------------------o-------o------------------o----Xo--o?----------o------o-----------------o-----------o-o-----o----------------------o--o--------------------E
o-----o-------o--o------o---------o-----------------o---------o-o-o-------o--------o--o----o----o------------------------o---------o-----------------------------------------o---o----o----------------M
M--Eo----o-Xooo-o---o---o----Moo------?-------------X------------o-X--------------------------------X---------X-----o--M-----B-----o-E-o---X--------oo---X--Xoo---o----oo----o---X---o-----oB-------X--B
m--XE----XEX-|oT-EE--X|XXo---|EE----B-B-X|-X-ToMEX-o--ME|-T-B|oE-|oToX----EEE--Bo-B--TX?XBooBo-o--|-?EX|--|EX-E--XT---XXT-B--T-X---EoB--E?XE|BoBoX---X---X--T--EEEX---XT-X--T-MEXooo-----B--|o-o-TXE|---
XXXXXX-XXXXXXXXXXXXXXXXXXX-XXXXXXXXXXX-XXXXXXXXXXXXXXXXXXXXXXXXXXXXXXXXXXXXXXXXXXXXXXXXXXXXXXXXXXXXXXXXXXXXXXXXXXXXXX-BXXXXXXXXXXXXXXXXXXXXXXXXXXXXXXXXXXXXXXXXXXXXXXXXX-XXXXXXXXXXXXX-XXXXoXXXX-XXXXXXX
