XB---BXo-XoB---X-B--X-----B----o-o---oB-o-o-B---o-X-XB--------o---XB----X-------X---BBo----B--o-------B----o-X------BXo----o---X--Bo-ooB------oo--X---B-------XXo--------B--o-X----Bo-----------------oo
|--o------------M---o----------o---------o-----o---o-X------o-X---o-o-o--o----o-o---XBB-----------o------------X------M------------X------------X---?X------?--X--------E|o----------------o------o-o--X
B------------oE-B-----------o--B-------o--o------oo-oo-------o--------Bo------------------------o-----o-o-o----o-o----ooo---o-----X-o-------o---o-XoXB----E-X----------o-X----------------o------------T
Xo-------B--------X-----M---o---------------X?---------------Bo-o--------o-------o------X-------?-----o-B-o----X------------------Xoo-X----oo-----o----oB-X-----o----o---X------------------o--------o-T
---------X-----o-----o--X---------o----------------X-----o----o---o-------?---------------------------o-B-----B-oo-----o----o-o-------B--o-------------X---o------------o------------o-------o----------
oo-----------X-B-------oB-----o---M-------X--------o?---------------------X---------------------o--|-o------o-B--o--o-------o----------oE---------o?---o----o-o--------B------------------o--------o--o|
o----o-------o----o----------o-B----------o--M-o----oo-o--o------------o-o---------o---------?o-B--X----------X-----o------------o-?----?----------Bo-oo-----------o---o-o-?---o--------------B-------o-
B-------X-------------------o--o----------o--o-B-?---B-----------oo------------------M-----o---oo-------T--XX-B----oX---o--X--------------o---------------X-------o-----M--X-----o------------oo-o--T-?v
E-----o-BX-------------------X------------oo-X---X-----o-----o---o------o---------o-oX--------oX--o-----X---o------X----o--------Eo-------X-X-------------o--o--------B-o------o----------------XM--X-oT
o----o---T---X--o------X----XX------X----------o--B--------o--E----------oo------Moo-----------o---------------------------------B-----oo---B--o--B-------B------E----X-o----------o---o---?----XXo-B--o
E--------X---X--M------B----------o-o-------------o---B-o-------o-------------o-?--B----------------o---o----o-o-----------o-o----o------B--------o----o-oo------B------?--o--oo---------ooo-----B--o--o
o---o---------M----------B---M---------------o-oX-----X-----------X----oo---o---o-----------------M-o------o----o---?o-o---o------B------B--o-----o------o--o-X-----o-X---------------o--?--o--o------M|
oo------oo----X-X--o-----B----o--------------o--o--------|--oo----B-------o--------X-----X--o-----X-----------------oX---------o--------o-----o--EX-o-----X-----------X-------------ooB---o---o-------X-
|----------o---Bo--?X-------o-o------ooo-B---?--o-----B-------M-oBo-o--------------------o----------X----o---X-----B----------------o---o---B----Bo-------o---------B--o-X--------------B------------o-o
m-o--TE-|-B-?-X-B-XooT-?|?-T-BB-----?-X-?EoE|BE|oB-EoBB----E-ETBTToB--?-TBE--B?-o-E-TX--|T-X-o--E-BTo-?o--E-XEX-B-TT-M-|-ooT|-B?-B----|-B--oBE---TXMBEo?-M---E-B--MTXX--BT|XE-M-X--BoX-XoX--MB------B--T
XXXXXXXXXXXXXXXXXXXXXXXXXXXXXXXXXXX-XXXXXXXXXXXXXXXXXXXXXXXXXXXXXXXXXXXXXXXXXXXX-XXXXX-XXXXXXXXXX-XXXXXXBXXXXXXXXXXXXXXXXXXXXXXXXXXX-XXXXXXXXXXXXXXEXXXXXXXXXXXXXXXXXXXXXXXXXXX-XXXXXXXXXXXXXXXXXXXXXX-X
