EB---BX--X-B-----B--X-----B----B-o-BX-B---o-----oBX--Bo---X---X---XB-------B--------BB---X-B-Eo--X---BB----o-X-E----BXo--------X--BX-o-B-------oo-X----B------XXo---X----BB-o-Xo--oB-----------Bo-----oo
|--o------------M---B----X---B-o---------oX-E--o-----Xo-----o--o------o?------o-oo---BB------B----------o---E--X---oX-M--B--------B----X------------?X------?-BXo--------|o--o---------o---o-----o--o--E
MXo---------oo--B----M---B--ooMB-------o--E-X--X-o--oo-------M---o----Bo------X-BoB---X-Eo------oo-o--o-o---B--o-o-------E--------X?o-------------XoXB----E-X-B-----o--o-XBo-----------o--o------------T
-o-------B--------X--T--MX--X-B---B--B----X----X--o----o-----Bo----------o--MXXE-oX-----B-X-----?-------B------XB--o-----M--------ooo-X----oo---o-oo---M--X----------o-M-X-----o?------E-----X--------o-
X--------X-----o--X--X--X--B------o--X?-o-------o-MX--Booo--o--o--o-------?-B--B----------B---------B--oB--E--B-o------o--Moo-o---M---B---------B----o-X-------------X---------T------BX--B--o-o--o----T
Bo-----------X-B-------oB-----o--XM-------X--o--?--o?-o-----o-----E-------X---XB----------------o--|Bo-----oo-B--o------o-X--------oo--oE----------?---o----o-o-M-E-B--B----X--MX-----B---o---?o------oE
-B---o-------BB---o-----------EB-X-X------o--M---o--oo---o--------B--------o-------o----X----?o-B--X-o----BB--XX-o--o--------o------?---?-o--------B--o---X-E-----?oX--o-o-?o--o---B--X----X--B-?-------
B-------X-----X---------------Bo---X------o--o--M?---B---X-?-----oo-----oo-----------M--B----E--o----o-ETo--X-BX---oX-o--------------Xo-X-o----------BB---X-X-----o-----M--XB----o-B----M-----ooMo--T-?v
B-----o-BX----X-X-----------XX-------?----B---o--X?--------B----o-BM----o------------X-------?oXX-o--X-XX---o------X--oX---EX----Eo-------X-X-----B-----M-o-Xo--------B-X---B----M-?----B-------XMB-Xoo|
E---?oo-BT---X--o------X--o-XX-----EXB---o-E---oX-B-----------o-o-oX-------------M-o-X------B--o---|---B-------------------MB----BB----o---?B-E-o-B-----X-B------E---oX-o-----E------X-o---?-----Xo-Bo-|
B---Xo---X---X--M------BE-?--------Xo------XX-o-T-o---B-o-----X-o-------------o-?E-B--------B-----TB----?----o-o---B---o---oX-----o------B--X-B--oo-o-B--oo------B---Mo-X--o--M--B---B---E-o--B--B--o--?
----o---------M-o-------XB----------------?----oX-----X----o------X----oo---o---oX-BB-X--------oo-MXX---o-----|--?--?o-o--oo---?--B------B---o----o---B--o--o------o-oM----B--X--XB---X--?--o-Bo------M|
To--B---------X-X----o---B-------o-o------X--o-----------oo-oo----B-----X-o-B---?o--B-B--X--------X----B--B-B-X-o---oX---EB--E-o--------o---B-o--EX-o--o--X----------------X--X--BX--oB-------o--o----XT
M----B-----o---BB---X-----o-ooX-------oEEB---B----o---B-----X---oBo-o--B----B----XEB---XooM-o-------o-oX-oB-XX-----B---------X-E----o---o---B----Bo--X----o--Xo-?---B--o-??X-------X----B----B-----|-o-B
m-o--T|-|TBo?|BoB-?oBTo-??-TEBB--E-T?Eoo?EoET-EXoBB-oTT-T|-E|BXBTXoB--?XX-E--B?TooBTT--||T|-Mo--EBBToB?oo-oX-E--B?TE--o|-BoMo-B?----E||XB--BBE---TX-BE-|oM-?EE-B|oMTX?--BTEXT-M-X|-BoX-BoX?-MX-MTT-|X--?
XXXXXXXXXXXXXXXXXXXXXXXXXXXXXXXXXXXXXXXXXXXXXXXXXXXXXXXXXXXXXXXXXXXXXXXXXXXXXXXXXXXXXX-XXXXXXXXXXXXXXXXXXXXXXXXXXXXXXXXXXXXXXXXXXXXXXXXXXXXXXXXXXXXEXXXXXXXXXXXXXXXXXXXXXXXXXXX-XX-XXXXXXXXXXXXXXXXXXX-X
