--------------------------------------------------------------------------------------------------------------------------------------------------------------------------------------------------------
--------------------------------------------------------------------------------------------------------------------------------------------------------------------------------------------------------
--------------------------------------------------------------------------------------------------------------------------------------------------------------------------------------------------------
--------------------------------------------------------------------------------------------------------------------------------------------------------------------------------------------------------
--------------------------------------------------------------------------------------------------------------------------------------------------------------------------------------------------------
--------------------------------------------------------------------------------------------------------------------------------------------------------------------------------------------------------
--------------------------------------------------------------------------------------------------------------------------------------------------------------------------------------------------------
-------------------------------------------------------------------------------------------------------------------------------------------------------------------------------------------------------v
---------------------------------B---------------------------------------------------------------------------------------------------------------------------------------------------------------------f
---------------------------------------------------------X---Bo--------------X-------------------------------------------------------------------------------------------------------------------------f
--------o----------------o------------------o------------o---------------------------o---------------------------o-------o--------------------------------------------B--------------------------------f
-------------------------o-T------------------------------------------------T-----------------------T-----------------------------------------------------------------TT---------------TT--------------f
-----------o--------------E---------------------|-------------------------|-?---------------------|----------------?---------||------------------------------?------||---------------------------------f
----------------|-----------------------------||-------?-T---||----X-------------------------------------------------?-------------TT------------------------------------------------------------------f
m||--?--E?X-BB||---BB--------E?-------?X-||--?-------E-X||-EX------B------E---X||----------||?--EB-|------------B----E------B---?--||------EX--B----------------?B----?----||--------B-|--?E?--?X-BE---X
XXXXXXXXXXXXXXXXXXXXXXXXXXXXXXXXXXXXXXXXXXXXXXXXXXXXXXXXXXXXXXXXXXXXXXXXXXXXXXXXXXXXXXXXXXXXXXXXXXXXXXXXXXXXXXXXXXXXXXXXXXXXXXXXXXXXXXXXXXXXXXXXXXXXXXXXXXXXXXXXXXXXXXXXXXXXXXXXXXXXXXXXXXXXXXXXXXXXXXXX
