X--B-X--X---XX-o--------X--B-X-----o--o---oX--------o-|---X--o----oB-X-oB----oo-BX---o---oX---X--B-B--XB------X-B-------X--------B-----X---B---X---o-----oXB--B-XB-X---o-o---X----o--------X?X----B-----
B-----X---o--X-----------o--------------------o--o-------o---o---------------------o------------o-----------o-oo---------o-B-------------------o-------------------------o---X-----------------o-o---o-E
X-o---------o----o-------------------o------------o-o----M--------X--------------oo--o----o------Xo----------------?----o----o---o-o----oX---------------o----------------oo---o----o----------o-------?
----------o------o---o--------------------o---o----o------o------o---o--oo-----o--------oo----o--o------o-----o-o--o---------------o-------o-o----------------------oo----o-o--------------------o-----B
E--------------o-X----------------o--X--------Xo-o--o----------o--X------------------o-o----------o---------o------------o-oo-o---o-----------o---------E----o---------o---o---o-------o-------o-------X
----------o--o-oo------o--X--o------o------------o--------o------------------------------o---------------o-----------------o-o----------o----o----------?---X-----------o--Xo-o--o--------------o------T
--------X-----ooo------------------------------------o--------------oo-----------------------------o--------o----o---o-?-?-----------------o--E-o------o----o-----------------X--------------o-----o---X
o------o-o------o--------o---o-------------------------------oo--------------------------------o-------------------------oo-------oo----o-o----o-----o-------o---o--M-------------------------o-----E-?v
T-----o----------------o--------------------------------------------oo?-o-o------------o---------o---o------------------------o--o-----ooo--o---------------o--------------o--------o-------o----?-----M
|----o---o-----------------------o------------o------------------o-o--o-------o-oo--------------Eo-o-----------------o----------o--------B-o-------------------o-o--o-----o---E-----------o------------B
o------------ooo-X-------------o-----o----X-------oo-------------------------------------------------o-------------o------?------o------------------------?----X------M-o-----B------o--------o--------M
T------------o--M---o----o------------------X------------------------------o----------o----o---o--o------oo--o----------o---------o---o----o--oo---o-------------------o--o-------------M-o------------?
---oooo------oo---------o--o-----------------oo----------------------------------------------o----------------oo---------oo-------o----------------o----o------o--o-o-o-----------------o------oX---o-o|
|--o---------M-------------------------o-o--o--------------X--o------o-------------------M--o----------------oo---------B--o---o--o----o-X-----------------X-----oX--o-o---------o----o-----o-o--------E
m-BBM?--?BE|-----X-BME--EEX-?BBXE--EX----|ooT--EXoE|oTo-E--oM-EXB-|-X---o--?-BEEXXMEE-B-oo|----TX--?X--o----BE---E-o-E--|--Xo-MX-|--o---oE--o--?B------Xo---|T-EX|TooET-o-|o-o-XX--X-T||-X-?-|--o-|B|o-B
XXXXXXXXXXXXXXX--XXXXXXBXXXXXXXXXXXXXXXXXXXXXX-XXXXXXXXEXXXXXXXXXXXXXXXXXXXXBXXXXXXXXXXXXXXXXXXXXXXXXXXXXXXXXXXXXXXXXXXXXXXXXXXXXXXXXXXX-XXXXXXXXXXXoX-XXXXXXXoXXXXXXXXXXXXXXXXXXXXXXXXXXXXXXXXX--XXXXXX
