--------------------------------------------------------------------------------------------------------------------------------------------------------------------------------------------------------
--------------------------------------------------------------------------------------------------------------------------------------------------------------------------------------------------------
--------------------------------------------------------------------------------------------------------------------------------------------------------------------------------------------------------
--------------------------------------------------------------------------------------------------------------------------------------------------------------------------------------------------------
--------------------------------------------------------------------------------------------------------------------------------------------------------------------------------------------------------
--------------------------------------------------------------------------------------------------------------------------------------------------------------------------------------------------------
--------------------------------------------------------------------------------------------------------------------------------------------------------------------------------------------------------
-------------------------------------------------------------------------------------------------------------------------------------------------------------------------------------------------------v
-------------------------------------------------------------------------------------------------------------------------------------------------------------------------------------------------------f
---------------------------------------------------------------------------------o---------------o-------------------------------o-----------o-----------------------------------------o---------------f
--------------------------------------------------------------------X----------o-o------------------------------------oo-------------------------------o-----------------------------------------------f
-TT-------o-----------o----------------------------------------o----o------------------------------------------------o-----------------o--------------------E-------------o----------------------------f
-------------------------TT------------------------B---------TT----------------------------------||----------------------TT---------T---------T-----------------------o--------------------------------f
----------------------------------||---------------X---------------T-----|-------T----------||---------------------------||--------|X-------------T----------?------------o------------||--------?-----f
m------?B------?B--B----BB---||B?B-BB||--||E------X|-E------B---B?X?-------------|------B--X|-?-X--?-BE--------B-?----B--?---------||----------------E-------?--?--------------BE-B-------??----X||E---X
XXXXXXXXXXXXXXXXXXXXXXXXXXXXXXXXXXXXXXXXXXXXXXXXXXXXXXXXXXXXXXXXXXXXXXXXXXXXXXXXXXXXXXXXXXXXXXXXXXXXXXXXXXXXXXXXXXXXXXXXXXXXXXXXXXXXXXXXXXXXXXXXXXXXXXXXXXXXXXXXXXXXXXXXXXXXXXXXXXXXXXXXXXXXXXXXXXXXXXXX
