---------------------------------------------------------------------------------------------------------------------------------------------------------------------------------------------------------
---------------------------------------------------------------------------------------------------------------------------------------------------------------------------------------------------------
---------------------------------------------------------------------------------------------------------------------------------------------------------------------------------------------------------
---------------------------------------------------------------------------------------------------------------------------------------------------------------------------------------------------------
----------------------------------------------------------------------------------E----------------------------------------------------------------------------------------------------------------------
----------------------?---------------------------------------------------------BBBBBBBB---BBB?--------------?-----------BBB----B??B--------------------------------------------------------XX----------v
-------------------------------------------------------------------------------------------------------------------------------------------------------------------------------------------XXX----------f
-------------------------------------------------------------------------------E----------------------------------------------------------------------------------------------------------XXXX----------f
----------------------------------------------------------------B------------------------------------------------------------------------------------------------------------------------XXXXX----------f
----------------?---B?BMB----------------------------------------------------BMB--------------B-----BB----?--?--?-----B----------BB------X--X----------XX--X------------BB?B------------XXXXXX----------f
--------------------------------------T-------T----------T------------------------------------------------------------------------------XX--XX--------XXX--XX----------------------m---XXXXXXX----------f
----------------------------T---------|-------|----------|-----------------------------------------------------------------------------XXX--XXX------XXXX--XXX-----T---------------T--XXXXXXXX----------f
---------------------E------|---------|--E----|------E-E-|-------------------------------------E-E--------E-----------------EE-E-E----XXXX--XXXX----XXXXX--XXXX----|----------EE---|-XXXXXXXXX----------X
XXXXXXXXXXXXXXXXXXXXXXXXXXXXXXXXXXXXXXXXXXXXXXXXXXXXXXXXXXXXXXXXXXXXX--XXXXXXXXXXXXXXX--XXXXXXXXXXXXXXXXXXXXXXXXXXXXXXXXXXXXXXXXXXXXXXXXXXXXXXXXXXXXXXXXX--XXXXXXXXXXXXXXXXXXXXXXXXXXXXXXXXXXXXXXXXXXXXXX
